Yogyakarta	DI Yogyakarta
Yalimo	Papua
Yahukimo	Papua
Wonosobo	Jawa Tengah
Wonogiri	Jawa Tengah
Way Kanan	Lampung
Waropen	Papua
Wakatobi	Sulawesi Tenggara
Wajo	Sulawesi Selatan
Tulungagung	Jawa Timur
Tulang Bawang Barat	Lampung
Tulang Bawang	Lampung
Tuban	Jawa Timur
Tual	Maluku
Trenggalek	Jawa Timur
Toraja Utara	Sulawesi Selatan
Tomohon	Sulawesi Utara
Tolikara	Papua
Toli-Toli	Sulawesi Tengah
Tojo Una-Una	Sulawesi Tengah
Toba Samosir	Sumatera Utara
Timor Tengah Utara	Nusa Tenggara Timur (NTT)
Timor Tengah Selatan	Nusa Tenggara Timur (NTT)
Tidore Kepulauan	Maluku Utara
Ternate	Maluku Utara
Temanggung	Jawa Tengah
Teluk Wondama	Papua Barat
Teluk Bintuni	Papua Barat
Tegal	Jawa Tengah
Tegal	Jawa Tengah
Tebo	Jambi
Tebing Tinggi	Sumatera Utara
Tasikmalaya	Jawa Barat
Tasikmalaya	Jawa Barat
Tarakan	Kalimantan Utara
Tapin	Kalimantan Selatan
Tapanuli Utara	Sumatera Utara
Tapanuli Tengah	Sumatera Utara
Tapanuli Selatan	Sumatera Utara
Tanjung Pinang	Kepulauan Riau
Tanjung Jabung Timur	Jambi
Tanjung Jabung Barat	Jambi
Tanjung Balai	Sumatera Utara
Tanggamus	Lampung
Tangerang Selatan	Banten
Tangerang	Banten
Tangerang	Banten
Tanah Laut	Kalimantan Selatan
Tanah Datar	Sumatera Barat
Tanah Bumbu	Kalimantan Selatan
Tana Toraja	Sulawesi Selatan
Tana Tidung	Kalimantan Utara
Tambrauw	Papua Barat
Takalar	Sulawesi Selatan
Tabanan	Bali
Tabalong	Kalimantan Selatan
Surakarta	Jawa Tengah
Surabaya	Jawa Timur
Supiori	Papua
Sungaipenuh	Jambi
Sumenep	Jawa Timur
Sumedang	Jawa Barat
Sumbawa Barat	Nusa Tenggara Barat (NTB)
Sumbawa	Nusa Tenggara Barat (NTB)
Sumba Timur	Nusa Tenggara Timur (NTT)
Sumba Tengah	Nusa Tenggara Timur (NTT)
Sumba Barat Daya	Nusa Tenggara Timur (NTT)
Sumba Barat	Nusa Tenggara Timur (NTT)
Sukoharjo	Jawa Tengah
Sukamara	Kalimantan Tengah
Sukabumi	Jawa Barat
Sukabumi	Jawa Barat
Subulussalam	Aceh (NAD)
Subang	Jawa Barat
Sragen	Jawa Tengah
Sorong Selatan	Papua Barat
Sorong	Papua Barat
Sorong	Papua Barat
Soppeng	Sulawesi Selatan
Solok Selatan	Sumatera Barat
Solok	Sumatera Barat
Solok	Sumatera Barat
Sleman	DI Yogyakarta
Situbondo	Jawa Timur
Sintang	Kalimantan Barat
Sinjai	Sulawesi Selatan
Singkawang	Kalimantan Barat
Simeulue	Aceh (NAD)
Simalungun	Sumatera Utara
Sikka	Nusa Tenggara Timur (NTT)
Sijunjung	Sumatera Barat
Sigi	Sulawesi Tengah
Sidoarjo	Jawa Timur
Sidenreng Rappang	Sulawesi Selatan
Sibolga	Sumatera Utara
Siak	Riau
Seruyan	Kalimantan Tengah
Serdang Bedagai	Sumatera Utara
Serang	Banten
Serang	Banten
Seram Bagian Timur	Maluku
Seram Bagian Barat	Maluku
Semarang	Jawa Tengah
Semarang	Jawa Tengah
Seluma	Bengkulu
Sekadau	Kalimantan Barat
Sawah Lunto	Sumatera Barat
Sarolangun	Jambi
Sarmi	Papua
Sanggau	Kalimantan Barat
Sampang	Jawa Timur
Samosir	Sumatera Utara
Sambas	Kalimantan Barat
Samarinda	Kalimantan Timur
Salatiga	Jawa Tengah
Sabu Raijua	Nusa Tenggara Timur (NTT)
Sabang	Aceh (NAD)
Rote Ndao	Nusa Tenggara Timur (NTT)
Rokan Hulu	Riau
Rokan Hilir	Riau
Rembang	Jawa Tengah
Rejang Lebong	Bengkulu
Raja Ampat	Papua Barat
Purworejo	Jawa Tengah
Purwakarta	Jawa Barat
Purbalingga	Jawa Tengah
Puncak Jaya	Papua
Puncak	Papua
Pulau Taliabu	Maluku Utara
Pulau Morotai	Maluku Utara
Pulang Pisau	Kalimantan Tengah
Probolinggo	Jawa Timur
Probolinggo	Jawa Timur
Pringsewu	Lampung
Prabumulih	Sumatera Selatan
Poso	Sulawesi Tengah
Pontianak	Kalimantan Barat
Ponorogo	Jawa Timur
Polewali Mandar	Sulawesi Barat
Pohuwato	Gorontalo
Pinrang	Sulawesi Selatan
Pidie Jaya	Aceh (NAD)
Pidie	Aceh (NAD)
Pesisir Selatan	Sumatera Barat
Pesisir Barat	Lampung
Pesawaran	Lampung
Penukal Abab Lematang Ilir	Sumatera Selatan
Penajam Paser Utara	Kalimantan Timur
Pematang Siantar	Sumatera Utara
Pemalang	Jawa Tengah
Pelalawan	Riau
Pekanbaru	Riau
Pekalongan	Jawa Tengah
Pekalongan	Jawa Tengah
Pegunungan Bintang	Papua
Pegunungan Arfak	Papua Barat
Payakumbuh	Sumatera Barat
Pati	Jawa Tengah
Pasuruan	Jawa Timur
Pasuruan	Jawa Timur
Paser	Kalimantan Timur
Pasangkayu (Mamuju Utara)	Sulawesi Barat
Pasaman Barat	Sumatera Barat
Pasaman	Sumatera Barat
Parigi Moutong	Sulawesi Tengah
Pariaman	Sumatera Barat
Parepare	Sulawesi Selatan
Paniai	Papua
Pangkal Pinang	Kepulauan Bangka Belitung
Pangkajene Kepulauan	Sulawesi Selatan
Pangandaran	Jawa Barat
Pandeglang	Banten
Pamekasan	Jawa Timur
Palu	Sulawesi Tengah
Palopo	Sulawesi Selatan
Palembang	Sumatera Selatan
Palangka Raya	Kalimantan Tengah
Pakpak Bharat	Sumatera Utara
Pagar Alam	Sumatera Selatan
Padang Sidempuan	Sumatera Utara
Padang Pariaman	Sumatera Barat
Padang Panjang	Sumatera Barat
Padang Lawas Utara	Sumatera Utara
Padang Lawas	Sumatera Utara
Padang	Sumatera Barat
Pacitan	Jawa Timur
Ogan Komering Ulu Timur	Sumatera Selatan
Ogan Komering Ulu Selatan	Sumatera Selatan
Ogan Komering Ulu	Sumatera Selatan
Ogan Komering Ilir	Sumatera Selatan
Ogan Ilir	Sumatera Selatan
Nunukan	Kalimantan Utara
Nias Utara	Sumatera Utara
Nias Selatan	Sumatera Utara
Nias Barat	Sumatera Utara
Nias	Sumatera Utara
Ngawi	Jawa Timur
Nganjuk	Jawa Timur
Ngada	Nusa Tenggara Timur (NTT)
Nduga	Papua
Natuna	Kepulauan Riau
Nagekeo	Nusa Tenggara Timur (NTT)
Nagan Raya	Aceh (NAD)
Nabire	Papua
Musi Rawas Utara	Sumatera Selatan
Musi Rawas	Sumatera Selatan
Musi Banyuasin	Sumatera Selatan
Murung Raya	Kalimantan Tengah
Muna Barat	Sulawesi Tenggara
Muna	Sulawesi Tenggara
Muko Muko	Bengkulu
Muaro Jambi	Jambi
Muara Enim	Sumatera Selatan
Morowali Utara	Sulawesi Tengah
Morowali	Sulawesi Tengah
Mojokerto	Jawa Timur
Mojokerto	Jawa Timur
Minahasa Utara	Sulawesi Utara
Minahasa Tenggara	Sulawesi Utara
Minahasa Selatan	Sulawesi Utara
Minahasa	Sulawesi Utara
Mimika	Papua
Metro	Lampung
Mesuji	Lampung
Merauke	Papua
Merangin	Jambi
Mempawah	Kalimantan Barat
Melawi	Kalimantan Barat
Medan	Sumatera Utara
Maybrat	Papua Barat
Mataram	Nusa Tenggara Barat (NTB)
Maros	Sulawesi Selatan
Mappi	Papua
Manokwari Selatan	Papua Barat
Manokwari	Papua Barat
Manggarai Timur	Nusa Tenggara Timur (NTT)
Manggarai Barat	Nusa Tenggara Timur (NTT)
Manggarai	Nusa Tenggara Timur (NTT)
Mandailing Natal	Sumatera Utara
Manado	Sulawesi Utara
Mamuju Tengah	Sulawesi Barat
Mamuju	Sulawesi Barat
Mamberamo Tengah	Papua
Mamberamo Raya	Papua
Mamasa	Sulawesi Barat
Maluku Tenggara	Maluku
Maluku Tengah	Maluku
Maluku Barat Daya	Maluku
Malinau	Kalimantan Utara
Malang	Jawa Timur
Malang	Jawa Timur
Malaka	Nusa Tenggara Timur (NTT)
Makassar	Sulawesi Selatan
Majene	Sulawesi Barat
Majalengka	Jawa Barat
Mahakam Ulu	Kalimantan Timur
Magetan	Jawa Timur
Magelang	Jawa Tengah
Magelang	Jawa Tengah
Madiun	Jawa Timur
Madiun	Jawa Timur
Luwu Utara	Sulawesi Selatan
Luwu Timur	Sulawesi Selatan
Luwu	Sulawesi Selatan
Lumajang	Jawa Timur
Lubuk Linggau	Sumatera Selatan
Lombok Utara	Nusa Tenggara Barat (NTB)
Lombok Timur	Nusa Tenggara Barat (NTB)
Lombok Tengah	Nusa Tenggara Barat (NTB)
Lombok Barat	Nusa Tenggara Barat (NTB)
Lingga	Kepulauan Riau
Lima Puluh Kota	Sumatera Barat
Lhokseumawe	Aceh (NAD)
Lembata	Nusa Tenggara Timur (NTT)
Lebong	Bengkulu
Lebak	Banten
Lanny Jaya	Papua
Langsa	Aceh (NAD)
Langkat	Sumatera Utara
Landak	Kalimantan Barat
Lampung Utara	Lampung
Lampung Timur	Lampung
Lampung Tengah	Lampung
Lampung Selatan	Lampung
Lampung Barat	Lampung
Lamongan	Jawa Timur
Lamandau	Kalimantan Tengah
Lahat	Sumatera Selatan
Labuhanbatu Utara	Sumatera Utara
Labuhanbatu Selatan	Sumatera Utara
Labuhanbatu	Sumatera Utara
Kutai Timur	Kalimantan Timur
Kutai Kartanegara	Kalimantan Timur
Kutai Barat	Kalimantan Timur
Kupang	Nusa Tenggara Timur (NTT)
Kupang	Nusa Tenggara Timur (NTT)
Kuningan	Jawa Barat
Kulon Progo	DI Yogyakarta
Kudus	Jawa Tengah
Kubu Raya	Kalimantan Barat
Kuantan Singingi	Riau
Kotawaringin Timur	Kalimantan Tengah
Kotawaringin Barat	Kalimantan Tengah
Kotamobagu	Sulawesi Utara
Kotabaru	Kalimantan Selatan
Konawe Utara	Sulawesi Tenggara
Konawe Selatan	Sulawesi Tenggara
Konawe Kepulauan	Sulawesi Tenggara
Konawe	Sulawesi Tenggara
Kolaka Utara	Sulawesi Tenggara
Kolaka Timur	Sulawesi Tenggara
Kolaka	Sulawesi Tenggara
Klungkung	Bali
Klaten	Jawa Tengah
Ketapang	Kalimantan Barat
Kerinci	Jambi
Kepulauan Yapen	Papua
Kepulauan Tanimbar (Maluku Tenggara Barat)	Maluku
Kepulauan Talaud	Sulawesi Utara
Kepulauan Sula	Maluku Utara
Kepulauan Siau Tagulandang Biaro (Sitaro)	Sulawesi Utara
Kepulauan Seribu	DKI Jakarta
Kepulauan Selayar	Sulawesi Selatan
Kepulauan Sangihe	Sulawesi Utara
Kepulauan Meranti	Riau
Kepulauan Mentawai	Sumatera Barat
Kepulauan Aru	Maluku
Kepulauan Anambas	Kepulauan Riau
Kepahiang	Bengkulu
Kendari	Sulawesi Tenggara
Kendal	Jawa Tengah
Keerom	Papua
Kediri	Jawa Timur
Kediri	Jawa Timur
Kebumen	Jawa Tengah
Kayong Utara	Kalimantan Barat
Kaur	Bengkulu
Katingan	Kalimantan Tengah
Karo	Sumatera Utara
Karimun	Kepulauan Riau
Karawang	Jawa Barat
Karangasem	Bali
Karanganyar	Jawa Tengah
Kapuas Hulu	Kalimantan Barat
Kapuas	Kalimantan Tengah
Kampar	Riau
Kaimana	Papua Barat
Jombang	Jawa Timur
Jepara	Jawa Tengah
Jeneponto	Sulawesi Selatan
Jembrana	Bali
Jember	Jawa Timur
Jayawijaya	Papua
Jayapura	Papua
Jayapura	Papua
Jambi	Jambi
Jakarta Utara	DKI Jakarta
Jakarta Timur	DKI Jakarta
Jakarta Selatan	DKI Jakarta
Jakarta Pusat	DKI Jakarta
Jakarta Barat	DKI Jakarta
Intan Jaya	Papua
Indramayu	Jawa Barat
Indragiri Hulu	Riau
Indragiri Hilir	Riau
Humbang Hasundutan	Sumatera Utara
Hulu Sungai Utara	Kalimantan Selatan
Hulu Sungai Tengah	Kalimantan Selatan
Hulu Sungai Selatan	Kalimantan Selatan
Halmahera Utara	Maluku Utara
Halmahera Timur	Maluku Utara
Halmahera Tengah	Maluku Utara
Halmahera Selatan	Maluku Utara
Halmahera Barat	Maluku Utara
Gunungsitoli	Sumatera Utara
Gunung Mas	Kalimantan Tengah
Gunung Kidul	DI Yogyakarta
Grobogan	Jawa Tengah
Gresik	Jawa Timur
Gowa	Sulawesi Selatan
Gorontalo Utara	Gorontalo
Gorontalo	Gorontalo
Gorontalo	Gorontalo
Gianyar	Bali
Gayo Lues	Aceh (NAD)
Garut	Jawa Barat
Flores Timur	Nusa Tenggara Timur (NTT)
Fakfak	Papua Barat
Enrekang	Sulawesi Selatan
Ende	Nusa Tenggara Timur (NTT)
Empat Lawang	Sumatera Selatan
Dumai	Riau
Donggala	Sulawesi Tengah
Dompu	Nusa Tenggara Barat (NTB)
Dogiyai	Papua
Dharmasraya	Sumatera Barat
Depok	Jawa Barat
Denpasar	Bali
Demak	Jawa Tengah
Deli Serdang	Sumatera Utara
Deiyai	Papua
Dairi	Sumatera Utara
Cirebon	Jawa Barat
Cirebon	Jawa Barat
Cimahi	Jawa Barat
Cilegon	Banten
Cilacap	Jawa Tengah
Cianjur	Jawa Barat
Ciamis	Jawa Barat
Buton Utara	Sulawesi Tenggara
Buton Tengah	Sulawesi Tenggara
Buton Selatan	Sulawesi Tenggara
Buton	Sulawesi Tenggara
Buru Selatan	Maluku
Buru	Maluku
Buol	Sulawesi Tengah
Bungo	Jambi
Bulungan	Kalimantan Utara
Bulukumba	Sulawesi Selatan
Buleleng	Bali
Bukittinggi	Sumatera Barat
Brebes	Jawa Tengah
Boyolali	Jawa Tengah
Boven Digoel	Papua
Bontang	Kalimantan Timur
Bone Bolango	Gorontalo
Bone	Sulawesi Selatan
Bondowoso	Jawa Timur
Bombana	Sulawesi Tenggara
Bolaang Mongondow Utara	Sulawesi Utara
Bolaang Mongondow Timur	Sulawesi Utara
Bolaang Mongondow Selatan	Sulawesi Utara
Bolaang Mongondow	Sulawesi Utara
Bojonegoro	Jawa Timur
Bogor	Jawa Barat
Bogor	Jawa Barat
Boalemo	Gorontalo
Blora	Jawa Tengah
Blitar	Jawa Timur
Blitar	Jawa Timur
Bitung	Sulawesi Utara
Bireuen	Aceh (NAD)
Bintan	Kepulauan Riau
Binjai	Sumatera Utara
Bima	Nusa Tenggara Barat (NTB)
Bima	Nusa Tenggara Barat (NTB)
Biak Numfor	Papua
Berau	Kalimantan Timur
Bengkulu Utara	Bengkulu
Bengkulu Tengah	Bengkulu
Bengkulu Selatan	Bengkulu
Bengkulu	Bengkulu
Bengkayang	Kalimantan Barat
Bengkalis	Riau
Bener Meriah	Aceh (NAD)
Belu	Nusa Tenggara Timur (NTT)
Belitung Timur	Kepulauan Bangka Belitung
Belitung	Kepulauan Bangka Belitung
Bekasi	Jawa Barat
Bekasi	Jawa Barat
Bau-Bau	Sulawesi Tenggara
Batu Bara	Sumatera Utara
Batu	Jawa Timur
Batang Hari	Jambi
Batang	Jawa Tengah
Batam	Kepulauan Riau
Barru	Sulawesi Selatan
Barito Utara	Kalimantan Tengah
Barito Timur	Kalimantan Tengah
Barito Selatan	Kalimantan Tengah
Barito Kuala	Kalimantan Selatan
Banyuwangi	Jawa Timur
Banyumas	Jawa Tengah
Banyuasin	Sumatera Selatan
Bantul	DI Yogyakarta
Bantaeng	Sulawesi Selatan
Banjarnegara	Jawa Tengah
Banjarmasin	Kalimantan Selatan
Banjarbaru	Kalimantan Selatan
Banjar	Kalimantan Selatan
Banjar	Jawa Barat
Bangli	Bali
Bangkalan	Jawa Timur
Bangka Tengah	Kepulauan Bangka Belitung
Bangka Selatan	Kepulauan Bangka Belitung
Bangka Barat	Kepulauan Bangka Belitung
Bangka	Kepulauan Bangka Belitung
Banggai Laut	Sulawesi Tengah
Banggai Kepulauan	Sulawesi Tengah
Banggai	Sulawesi Tengah
Bandung Barat	Jawa Barat
Bandung	Jawa Barat
Bandung	Jawa Barat
Bandar Lampung	Lampung
Banda Aceh	Aceh (NAD)
Balikpapan	Kalimantan Timur
Balangan	Kalimantan Selatan
Badung	Bali
Asmat	Papua
Asahan	Sumatera Utara
Ambon	Maluku
Alor	Nusa Tenggara Timur (NTT)
Agam	Sumatera Barat
Aceh Utara	Aceh (NAD)
Aceh Timur	Aceh (NAD)
Aceh Tenggara	Aceh (NAD)
Aceh Tengah	Aceh (NAD)
Aceh Tamiang	Aceh (NAD)
Aceh Singkil	Aceh (NAD)
Aceh Selatan	Aceh (NAD)
Aceh Jaya	Aceh (NAD)
Aceh Besar	Aceh (NAD)
Aceh Barat Daya	Aceh (NAD)
Aceh Barat	Aceh (NAD)