2 X 11 Enam Lingkuang	Padang Pariaman
2 X 11 Kayu Tanam	Padang Pariaman
Abab	Penukal Abab Lematang Ilir
Abang	Karangasem
Abeli	Kendari
Abenaho	Yalimo
Abepura	Jayapura
Abiansemal	Badung
Aboy	Pegunungan Bintang
Abuki	Konawe
Abun	Tambrauw
Abung Barat	Lampung Utara
Abung Kunang	Lampung Utara
Abung Pekurun	Lampung Utara
Abung Selatan	Lampung Utara
Abung Semuli	Lampung Utara
Abung Surakarta	Lampung Utara
Abung Tengah	Lampung Utara
Abung Timur	Lampung Utara
Abung Tinggi	Lampung Utara
Adian Koting	Tapanuli Utara
Adiluwih (Adi Luwih)	Pringsewu
Adimulyo	Kebumen
Adipala	Cilacap
Adiwerna	Tegal
Adonara	Flores Timur
Adonara Barat	Flores Timur
Adonara Tengah	Flores Timur
Adonara Timur	Flores Timur
Aek Bilah	Tapanuli Selatan
Aek Kuasan	Asahan
Aek Kuo	Labuhanbatu Utara
Aek Ledong	Asahan
Aek Nabara Barumun	Padang Lawas
Aek Natas	Labuhanbatu Utara
Aek Songsongan	Asahan
Aere	Kolaka Timur
Aertembaga (Bitung Timur)	Bitung
Aesesa	Nagekeo
Aesesa Selatan	Nagekeo
Afulu	Nias Utara
Agandugume	Puncak
Agats	Asmat
Agimuga	Mimika
Agisiga	Intan Jaya
Agrabinta	Cianjur
Aifat	Maybrat
Aifat Selatan	Maybrat
Aifat Timur	Maybrat
Aifat Timur Jauh	Maybrat
Aifat Timur Selatan	Maybrat
Aifat Timur Tengah	Maybrat
Aifat Utara	Maybrat
Aikmel	Lombok Timur
Aimando Padaido	Biak Numfor
Aimas	Sorong
Aimere	Ngada
Air Batu	Asahan
Air Besar	Landak
Air Besi	Bengkulu Utara
Air Buaya (Airbuaya)	Buru
Air Dikit	Muko Muko
Air Gegas	Bangka Selatan
Air Hangat	Kerinci
Air Hangat Barat	Kerinci
Air Hangat Timur	Kerinci
Air Hitam	Sarolangun
Air Hitam	Lampung Barat
Air Joman	Asahan
Air Kumbang	Banyuasin
Air Majunto	Muko Muko
Air Naningan	Tanggamus
Air Napal	Bengkulu Utara
Air Nipis	Bengkulu Selatan
Air Padang	Bengkulu Utara
Air Periukan	Seluma
Air Putih	Batu Bara
Air Rami	Muko Muko
Air Salek	Banyuasin
Air Sugihan	Ogan Komering Ilir
Air Upas	Ketapang
Airgaram	Tolikara
Airmadidi	Minahasa Utara
Airpura	Pesisir Selatan
Airu	Jayapura
Aitinyo	Maybrat
Aitinyo Barat	Maybrat
Aitinyo Raya	Maybrat
Aitinyo Tengah	Maybrat
Aitinyo Utara	Maybrat
Ajangale	Bone
Ajibarang	Banyumas
Ajibata	Toba Samosir
Ajung	Jember
Akabiluru	Lima Puluh Kota
Akat	Asmat
Alak	Kupang
Alalak	Barito Kuala
Alam Barajo	Jambi
Alama	Nduga
Alama	Mimika
Alang Alang Lebar	Palembang
Alapan (Alafan)	Simeulue
Alas	Sumbawa
Alas Barat	Sumbawa
Alasa	Nias Utara
Alasa Talumuzoi	Nias Utara
Alemsom	Pegunungan Bintang
Alian/Aliyan	Kebumen
Alla	Enrekang
Alok	Sikka
Alok Barat	Sikka
Alok Timur	Sikka
Alor Barat Daya	Alor
Alor Barat Laut	Alor
Alor Selatan	Alor
Alor Tengah Utara	Alor
Alor Timur	Alor
Alor Timur Laut	Alor
Alu (Allu)	Polewali Mandar
Aluh-Aluh	Banjar
Amabi Oefeto	Kupang
Amabi Oefeto Timur	Kupang
Amahai	Maluku Tengah
Amalatu	Seram Bagian Barat
Amali	Bone
Amanatun Selatan	Timor Tengah Selatan
Amanatun Utara	Timor Tengah Selatan
Amandraya	Nias Selatan
Amanuban Barat	Timor Tengah Selatan
Amanuban Selatan	Timor Tengah Selatan
Amanuban Tengah	Timor Tengah Selatan
Amanuban Timur	Timor Tengah Selatan
Amar	Mimika
Amarasi	Kupang
Amarasi Barat	Kupang
Amarasi Selatan	Kupang
Amarasi Timur	Kupang
Ambal	Kebumen
Ambalau	Sintang
Ambalau	Buru Selatan
Ambalawi	Bima
Ambarawa	Pringsewu
Ambarawa	Semarang
Ambatkwi (Ambatkui)	Boven Digoel
Amberbaken	Tambrauw
Amberbaken Barat	Tambrauw
Ambulu	Jember
Ambunten	Sumenep
Amen	Lebong
Amfoang Barat Daya	Kupang
Amfoang Barat Laut	Kupang
Amfoang Selatan	Kupang
Amfoang Tengah	Kupang
Amfoang Timur	Kupang
Amfoang Utara	Kupang
Amonggedo	Konawe
Ampana Kota	Tojo Una-Una
Ampana Tete	Tojo Una-Una
Ampek Nagari (IV Nagari )	Agam
Ampel	Boyolali
Ampelgading	Pemalang
Ampelgading	Malang
Ampenan	Mataram
Ampibabo	Parigi Moutong
Amuma	Yahukimo
Amungkalpia	Puncak
Amuntai Selatan	Hulu Sungai Utara
Amuntai Tengah	Hulu Sungai Utara
Amuntai Utara	Hulu Sungai Utara
Amurang	Minahasa Selatan
Amurang Barat	Minahasa Selatan
Amurang Timur	Minahasa Selatan
Anak Ratu Aji	Lampung Tengah
Anak Tuha	Lampung Tengah
Anawi	Tolikara
Andam Dewi	Tapanuli Tengah
Andey	Biak Numfor
Andir	Bandung
Andong	Boyolali
Andoolo	Konawe Selatan
Andoolo Barat	Konawe Selatan
Andowia	Konawe Utara
Angata	Konawe Selatan
Anggaberi	Konawe
Anggalomoare	Konawe
Anggana	Kutai Kartanegara
Anggeraja	Enrekang
Anggi	Pegunungan Arfak
Anggi Gida	Pegunungan Arfak
Anggrek	Gorontalo Utara
Anggruk	Yahukimo
Angkaisera	Kepulauan Yapen
Angkinang	Hulu Sungai Selatan
Angkola Barat	Tapanuli Selatan
Angkola Muara Tais	Tapanuli Selatan
Angkola Sangkunur	Tapanuli Selatan
Angkola Selatan	Tapanuli Selatan
Angkola Timur	Tapanuli Selatan
Angkona	Luwu Timur
Angsana	Tanah Bumbu
Angsana	Pandeglang
Animha	Merauke
Anjatan	Indramayu
Anjir Muara	Barito Kuala
Anjir Pasar	Barito Kuala
Anjongan	Mempawah
Anotaurei	Kepulauan Yapen
Anreapi	Polewali Mandar
Antang Kalang	Kotawaringin Timur
Antapani (Cicadas)	Bandung
Anyar	Serang
Apalapsili	Yalimo
Apawer Hulu	Sarmi
Aradide	Paniai
Arahan	Indramayu
Aralle	Mamasa
Aramo	Nias Selatan
Aranday	Teluk Bintuni
Aranio	Banjar
Arcamanik	Bandung
Argapura	Majalengka
Argomulyo	Salatiga
Arguni	Fakfak
Arimop	Boven Digoel
Arjasa	Jember
Arjasa	Situbondo
Arjasa	Sumenep
Arjasari	Bandung
Arjawinangun	Cirebon
Arjosari	Pacitan
Arma Jaya	Bengkulu Utara
Aroba	Teluk Bintuni
Arongan Lambalek	Aceh Barat
Arosbaya	Bangkalan
Arse	Tapanuli Selatan
Arso	Keerom
Arso Barat	Keerom
Arso Timur	Keerom
Aru Selatan	Kepulauan Aru
Aru Selatan Timur	Kepulauan Aru
Aru Selatan Utara	Kepulauan Aru
Aru Tengah	Kepulauan Aru
Aru Tengah Selatan	Kepulauan Aru
Aru Tengah Timur	Kepulauan Aru
Aru Utara	Kepulauan Aru
Aru Utara Timur Batuley	Kepulauan Aru
Arungkeke	Jeneponto
Arut Selatan	Kotawaringin Barat
Arut Utara	Kotawaringin Barat
Asakota	Bima
Asam Jujuhan	Dharmasraya
Asem Rowo (Asemrowo)	Surabaya
Asembagus	Situbondo
Asera	Konawe Utara
Ases	Tambrauw
Asinua	Konawe
Asologaima (Asalogaima)	Jayawijaya
Asolokobal	Jayawijaya
Asotipo	Jayawijaya
Asparaga	Gorontalo
Assue	Mappi
Astambul	Banjar
Astana Anyar	Bandung
Astanajapura	Cirebon
Atadei	Lembata
Atambua Barat	Belu
Atambua Selatan	Belu
Atinggola	Gorontalo Utara
Atsy / Atsj	Asmat
Atu Lintang	Aceh Tengah
Aur Birugo Tigo Baleh	Bukittinggi
Awan Rante Karua	Toraja Utara
Awang	Barito Timur
Awangpone	Bone
Awayan	Balangan
Aweida	Paniai
Aweku	Tolikara
Awina	Lanny Jaya
Awinbon	Pegunungan Bintang
Ayah	Kebumen
Ayamaru	Maybrat
Ayamaru Barat	Maybrat
Ayamaru Jaya	Maybrat
Ayamaru Selatan	Maybrat
Ayamaru Selatan Jaya	Maybrat
Ayamaru Tengah	Maybrat
Ayamaru Timur	Maybrat
Ayamaru Timur Selatan	Maybrat
Ayamaru Utara	Maybrat
Ayamaru Utara Timur	Maybrat
Ayau	Raja Ampat
Ayip	Asmat
Ayumnati	Lanny Jaya
Baamang	Kotawaringin Timur
Babadan	Ponorogo
Babah Rot	Aceh Barat Daya
Babakan	Cirebon
Babakan Ciparay	Bandung
Babakan Madang	Bogor
Babakancikao	Purwakarta
Babalan	Langkat
Babat	Lamongan
Babat Supat	Musi Banyuasin
Babat Toman	Musi Banyuasin
Babelan	Bekasi
Babirik	Hulu Sungai Utara
Babo	Teluk Bintuni
Babul Makmur	Aceh Tenggara
Babul Rahmah	Aceh Tenggara
Babulu	Penajam Paser Utara
Babussalam	Aceh Tenggara
Bacan	Halmahera Selatan
Bacan Barat	Halmahera Selatan
Bacan Barat Utara	Halmahera Selatan
Bacan Selatan	Halmahera Selatan
Bacan Timur	Halmahera Selatan
Bacan Timur Selatan	Halmahera Selatan
Bacan Timur Tengah	Halmahera Selatan
Bacukiki	Parepare
Bacukiki Barat	Parepare
Badar	Aceh Tenggara
Badas	Kediri
Badau	Belitung
Badau	Kapuas Hulu
Badegan	Ponorogo
Badiri	Tapanuli Tengah
Bae	Kudus
Baebunta	Luwu Utara
Baebunta Selatan	Luwu Utara
Bagan Sinembah	Rokan Hilir
Bagan Sinembah Raya	Rokan Hilir
Bagelen	Purworejo
Bagor	Nganjuk
Baguala	Ambon
Bagun	Sorong
Bahar Selatan	Muaro Jambi
Bahar Utara	Muaro Jambi
Bahau Hulu	Malinau
Bahodopi	Morowali
Bahorok	Langkat
Bahuga	Way Kanan
Baito	Konawe Selatan
Baiturrahman	Banda Aceh
Baitussalam	Aceh Besar
Bajawa	Ngada
Bajawa Utara	Ngada
Bajeng	Gowa
Bajeng Barat	Gowa
Bajenis	Tebing Tinggi
Bajo	Luwu
Bajo Barat	Luwu
Bajubang	Batang Hari
Bajuin	Tanah Laut
Bakam	Bangka
Bakarangan	Tapin
Bakauheni	Lampung Selatan
Baki	Sukoharjo
Bakongan	Aceh Selatan
Bakongan Timur	Aceh Selatan
Baktiraja (Bakti Raja)	Humbang Hasundutan
Baktiya	Aceh Utara
Baktiya Barat	Aceh Utara
Bakumpai	Barito Kuala
Bakung	Blitar
Bakung Serumpun	Lingga
Balaesang	Donggala
Balaesang Tanjung	Donggala
Balai	Sanggau
Balai Jaya	Rokan Hilir
Balai Riam	Sukamara
Balanipa	Polewali Mandar
Balantak	Banggai
Balantak Selatan	Banggai
Balantak Utara	Banggai
Balapulang	Tegal
Balaraja	Tangerang
Baleendah	Bandung
Balen	Bojonegoro
Balerejo	Madiun
Balige	Toba Samosir
Balik Bukit	Lampung Barat
Balikpapan Barat	Balikpapan
Balikpapan Kota	Balikpapan
Balikpapan Selatan	Balikpapan
Balikpapan Tengah	Balikpapan
Balikpapan Timur	Balikpapan
Balikpapan Utara	Balikpapan
Balingga	Lanny Jaya
Balingga Barat	Lanny Jaya
Balinggi	Parigi Moutong
Balla	Mamasa
Balocci	Pangkajene Kepulauan
Balong	Ponorogo
Balongan	Indramayu
Balongbendo	Sidoarjo
Balongpanggang (Balong Panggang)	Gresik
Balung	Jember
Balusu	Barru
Balusu	Toraja Utara
Bambaira	Pasangkayu (Mamuju Utara)
Bambalamotu	Pasangkayu (Mamuju Utara)
Bambang	Mamasa
Bambanglipuro (Bambang Lipuro)	Bantul
Bambel	Aceh Tenggara
Bamgi	Mappi
Bamusbama	Tambrauw
Banama Tingang	Pulang Pisau
Banawa	Donggala
Banawa Selatan	Donggala
Banawa Tengah	Donggala
Bancak	Semarang
Bancar	Tuban
Banda	Maluku Tengah
Banda Alam	Aceh Timur
Banda Baro	Aceh Utara
Banda Mulia	Aceh Tamiang
Banda Raya	Banda Aceh
Banda Sakti	Lhokseumawe
Bandar	Pacitan
Bandar	Bener Meriah
Bandar	Batang
Bandar	Simalungun
Bandar Baru	Pidie Jaya
Bandar Dua	Pidie Jaya
Bandar Huluan	Simalungun
Bandar Khalifah	Serdang Bedagai
Bandar Laksamana	Bengkalis
Bandar Masilam	Simalungun
Bandar Mataram	Lampung Tengah
Bandar Negeri Semuong	Tanggamus
Bandar Negeri Suoh	Lampung Barat
Bandar Pasir Mandoge	Asahan
Bandar Petalangan	Pelalawan
Bandar Pulau	Asahan
Bandar Pusaka	Aceh Tamiang
Bandar Sei Kijang	Pelalawan
Bandar Sribhawono (Bandar Sribawono)	Lampung Timur
Bandar Surabaya	Lampung Tengah
Bandarkedungmulyo (Bandar Kedung Mulyo)	Jombang
Banding Agung	Ogan Komering Ulu Selatan
Bandongan	Magelang
Bandung	Serang
Bandung	Tulungagung
Bandung Kidul	Bandung
Bandung Kulon	Bandung
Bandung Wetan	Bandung
Bandungan	Semarang
Bang Haji	Bengkulu Tengah
Banggae	Majene
Banggae Timur	Majene
Banggai	Banggai Laut
Banggai Selatan	Banggai Laut
Banggai Tengah	Banggai Laut
Banggai Utara	Banggai Laut
Bangil	Pasuruan
Bangilan	Tuban
Bangkala	Jeneponto
Bangkala Barat	Jeneponto
Bangkalan	Bangkalan
Bangkelekila	Toraja Utara
Bangkinang	Kampar
Bangkinang Kota	Kampar
Bangko	Rokan Hilir
Bangko	Merangin
Bangko Barat	Merangin
Bangko Pusaka (Pusako)	Rokan Hilir
Bangkunat (Bengkunat)	Pesisir Barat
Bangkurung	Banggai Laut
Bangli	Bangli
Bangodua	Indramayu
Bangorejo	Banyuwangi
Bangsal	Mojokerto
Bangsalsari	Jember
Bangsri	Jepara
Bangun Purba	Rokan Hulu
Bangun Purba	Deli Serdang
Bangun Rejo	Lampung Tengah
Banguntapan	Bantul
Banjang	Hulu Sungai Utara
Banjar	Buleleng
Banjar	Pandeglang
Banjar	Banjar
Banjar Agung	Tulang Bawang
Banjar Baru	Tulang Bawang
Banjar Margo	Tulang Bawang
Banjaran	Bandung
Banjaran	Majalengka
Banjarangkan	Klungkung
Banjaranyar	Ciamis
Banjarbaru Selatan (Banjar Baru Selatan)	Banjarbaru
Banjarbaru Utara (Banjar Baru Utara)	Banjarbaru
Banjarejo	Blora
Banjarharjo	Brebes
Banjarmangu	Banjarnegara
Banjarmasin Barat	Banjarmasin
Banjarmasin Selatan	Banjarmasin
Banjarmasin Tengah	Banjarmasin
Banjarmasin Timur	Banjarmasin
Banjarmasin Utara	Banjarmasin
Banjarnegara	Banjarnegara
Banjarsari	Lebak
Banjarsari	Ciamis
Banjarsari	Surakarta
Banjarwangi	Garut
Banjit	Way Kanan
Bansari	Temanggung
Bantaeng	Bantaeng
Bantan	Bengkalis
Bantaran	Probolinggo
Bantarbolang	Pemalang
Bantargadung	Sukabumi
Bantargebang (Bantar Gebang)	Bekasi
Bantarkalong	Tasikmalaya
Bantarkawung	Brebes
Bantarsari	Cilacap
Bantarujeg	Majalengka
Bantimurung	Maros
Bantul	Bantul
Bantur	Malang
Banua Lawas	Tabalong
Banua Lima	Barito Timur
Banuhampu	Agam
Banyakan	Kediri
Banyuanyar (Banyu Anyar)	Probolinggo
Banyuasin I	Banyuasin
Banyuasin II	Banyuasin
Banyuasin III	Banyuasin
Banyuates	Sampang
Banyubiru	Semarang
Banyudono	Boyolali
Banyuglugur	Situbondo
Banyuke Hulu	Landak
Banyumanik	Semarang
Banyumas	Banyumas
Banyumas	Pringsewu
Banyuputih	Situbondo
Banyuputih	Batang
Banyuresmi	Garut
Banyusari	Karawang
Banyuurip	Purworejo
Banyuwangi	Banyuwangi
Baolan	Toli-Toli
Bara	Palopo
Barabai	Hulu Sungai Tengah
Baradatu	Way Kanan
Baraka	Enrekang
Barambai	Barito Kuala
Barangin	Sawah Lunto
Barangka	Muna Barat
Baranti	Sidenreng Rappang
Baras	Pasangkayu (Mamuju Utara)
Barat	Magetan
Barebbo	Bone
Baregbeg	Ciamis
Bareng	Jombang
Barito Tuhup Raya	Murung Raya
Baroko	Enrekang
Barombong	Gowa
Baron	Nganjuk
Barong Tongkok	Kutai Barat
Baros	Serang
Baros	Sukabumi
Barru	Barru
Baruga	Kendari
Barumun	Padang Lawas
Barumun Selatan	Padang Lawas
Barumun Tengah	Padang Lawas
Baruppu	Toraja Utara
Barus	Tapanuli Tengah
Barus Utara	Tapanuli Tengah
Barusjahe (Barus Jahe)	Karo
Basa Ampek Balai Tapan	Pesisir Selatan
Basala	Konawe Selatan
Basarang	Kapuas
Basidondo	Toli-Toli
Baso	Agam
Basse Sangtempe (Bassesang Tempe / Bastem)	Luwu
Basse Sangtempe Utara	Luwu
Batabual	Buru
Bataguh	Kapuas
Batahan	Mandailing Natal
Batalaiwaru (Batalaiworu)	Muna
Batam Kota	Batam
Batang	Batang
Batang	Jeneponto
Batang Alai Selatan	Hulu Sungai Tengah
Batang Alai Timur	Hulu Sungai Tengah
Batang Alai Utara	Hulu Sungai Tengah
Batang Anai	Padang Pariaman
Batang Angkola	Tapanuli Selatan
Batang Asai	Sarolangun
Batang Asam	Tanjung Jabung Barat
Batang Batang	Sumenep
Batang Cenaku	Indragiri Hulu
Batang Gangsal (Batang Gansal)	Indragiri Hulu
Batang Gasan	Padang Pariaman
Batang Hari Leko	Musi Banyuasin
Batang Kapas	Pesisir Selatan
Batang Kawa	Lamandau
Batang Kuis	Deli Serdang
Batang Lubu Sutam	Padang Lawas
Batang Lupar	Kapuas Hulu
Batang Masumai	Merangin
Batang Merangin	Kerinci
Batang Natal	Mandailing Natal
Batang Onang	Padang Lawas Utara
Batang Peranap	Indragiri Hulu
Batang Serangan	Langkat
Batang Toru	Tapanuli Selatan
Batang Tuaka	Indragiri Hilir
Batangan	Pati
Batanghari	Lampung Timur
Batanghari Nuban	Lampung Timur
Batani	Pegunungan Bintang
Batanta Selatan	Raja Ampat
Batanta Utara	Raja Ampat
Batauga	Buton Selatan
Batealit	Jepara
Batee	Pidie
Bathin / Batin II Babeko	Bungo
Bathin II Pelayang	Bungo
Bathin III	Bungo
Bathin III Ulu	Bungo
Bathin Solapan	Bengkalis
Bathin VIII (Batin VIII)	Sarolangun
Bati-Bati	Tanah Laut
Batik Nau	Bengkulu Utara
Batin XXIV	Batang Hari
Batipuah Selatan (Batipuh Selatan)	Tanah Datar
Batipuh	Tanah Datar
Batom	Pegunungan Bintang
Batu	Batu
Batu Aji	Batam
Batu Ampar	Kubu Raya
Batu Ampar	Tanah Laut
Batu Ampar	Kutai Timur
Batu Ampar	Batam
Batu Ampar	Seruyan
Batu Atas	Buton Selatan
Batu Benawa	Hulu Sungai Tengah
Batu Brak	Lampung Barat
Batu Engau	Paser
Batu Hampar	Rokan Hilir
Batu Ketulis	Lampung Barat
Batu Lanteh (Batulanteh)	Sumbawa
Batu Lappa (Batulappa)	Pinrang
Batu Layar	Lombok Barat
Batu Licin (Batulicin)	Tanah Bumbu
Batu Mandi	Balangan
Batu Putih	Berau
Batu Putih	Timor Tengah Selatan
Batu Putih	Kolaka Utara
Batu Putih	Tulang Bawang Barat
Batu Sopang	Paser
Batuan	Sumenep
Batuceper	Tangerang
Batudaa	Gorontalo
Batudaa Pantai	Gorontalo
Batudaka	Tojo Una-Una
Batui	Banggai
Batui Selatan	Banggai
Batujajar	Bandung Barat
Batujaya	Karawang
Batukara	Muna
Batukliang	Lombok Tengah
Batukliang Utara	Lombok Tengah
Batumarmar	Pamekasan
Batununggal	Bandung
Batupoaro	Bau-Bau
Batuputih	Sumenep
Batur	Banjarnegara
Baturaja Barat	Ogan Komering Ulu
Baturaja Timur	Ogan Komering Ulu
Baturetno	Wonogiri
Baturiti	Tabanan
Baturraden (Baturaden)	Banyumas
Batuwarno	Wonogiri
Baula	Kolaka
Baureno	Bojonegoro
Bawang	Banjarnegara
Bawang	Batang
Bawen	Semarang
Bawolato	Nias
Baya Biru	Paniai
Bayah	Lebak
Bayan	Purworejo
Bayan	Lombok Utara
Bayang	Pesisir Selatan
Bayat	Klaten
Bayongbong	Garut
Bayung Lencir	Musi Banyuasin
Bebandem	Karangasem
Beber	Cirebon
Bebesen	Aceh Tengah
Beduai (Beduwai)	Sanggau
Bejen	Temanggung
Beji	Depok
Beji	Pasuruan
Bekasi Barat	Bekasi
Bekasi Selatan	Bekasi
Bekasi Timur	Bekasi
Bekasi Utara	Bekasi
Bekri	Lampung Tengah
Belah Batuh (Blahbatuh)	Gianyar
Belakang Padang	Batam
Belalau	Lampung Barat
Belang	Minahasa Tenggara
Belantikan Raya	Lamandau
Belat	Karimun
Belawa	Wajo
Belawang	Barito Kuala
Belida Darat	Muara Enim
Belik	Pemalang
Belimbing	Melawi
Belimbing	Muara Enim
Belimbing Hulu	Melawi
Belinyu	Bangka
Belitang	Sekadau
Belitang	Ogan Komering Ulu Timur
Belitang Hilir	Sekadau
Belitang Hulu	Sekadau
Belitang II	Ogan Komering Ulu Timur
Belitang III	Ogan Komering Ulu Timur
Belitang Jaya	Ogan Komering Ulu Timur
Belitang Madang Raya	Ogan Komering Ulu Timur
Belitang Mulya	Ogan Komering Ulu Timur
Belo	Bima
Belopa	Luwu
Belopa Utara	Luwu
Benai	Kuantan Singingi
Benakat	Muara Enim
Benawa	Yalimo
Benda	Tangerang
Bendahara	Aceh Tamiang
Bendo	Magetan
Bendosari	Sukoharjo
Bendungan	Trenggalek
Bener	Purworejo
Bener Kelipah	Bener Meriah
Bengalon	Kutai Timur
Bengkalis	Bengkalis
Bengkayang	Bengkayang
Bengkong	Batam
Bengo	Bone
Benjeng	Gresik
Benowo	Surabaya
Benteng	Kepulauan Selayar
Bentian Besar	Kutai Barat
Benua	Konawe Selatan
Benua Kayong	Ketapang
Benuki	Mamberamo Raya
Beo	Kepulauan Talaud
Beo Selatan	Kepulauan Talaud
Beo Utara	Kepulauan Talaud
Beoga	Puncak
Beoga Barat	Puncak
Beoga Timur	Puncak
Berampu (Brampu)	Dairi
Berandan Barat (Brandan Barat)	Langkat
Beraur	Sorong
Berbah	Sleman
Berbak	Tanjung Jabung Timur
Berbek	Nganjuk
Bergas	Semarang
Beringin	Deli Serdang
Bermani Ilir	Kepahiang
Bermani Ulu	Rejang Lebong
Bermani Ulu Raya	Rejang Lebong
Beruntung Baru	Banjar
Besitang	Langkat
Besuk	Probolinggo
Besuki	Situbondo
Besuki	Tulungagung
Besulutu	Konawe
Betara	Tanjung Jabung Barat
Betayau	Tana Tidung
Betcbamu	Asmat
Betoambari	Bau-Bau
Betung	Banyuasin
Beutong	Nagan Raya
Beutong Ateuh Banggalang	Nagan Raya
Bewani	Tolikara
Biak Barat	Biak Numfor
Biak Kota	Biak Numfor
Biak Timur	Biak Numfor
Biak Utara	Biak Numfor
Biandoga	Intan Jaya
Biaro	Kepulauan Siau Tagulandang Biaro (Sitaro)
Biatan	Berau
Biau	Gorontalo Utara
Biau	Buol
Bibida	Paniai
Biboki Anleu	Timor Tengah Utara
Biboki Feotleu	Timor Tengah Utara
Biboki Moenleu	Timor Tengah Utara
Biboki Selatan	Timor Tengah Utara
Biboki Tan Pah	Timor Tengah Utara
Biboki Utara	Timor Tengah Utara
Biduk-Biduk	Berau
Bies	Aceh Tengah
Bika	Kapuas Hulu
Bikar	Tambrauw
Bikomi Nilulat	Timor Tengah Utara
Bikomi Selatan	Timor Tengah Utara
Bikomi Tengah	Timor Tengah Utara
Bikomi Utara	Timor Tengah Utara
Bilah Barat	Labuhanbatu
Bilah Hilir	Labuhanbatu
Bilah Hulu	Labuhanbatu
Bilalang	Bolaang Mongondow
Bilato	Gorontalo
Biluhu	Gorontalo
Bime	Pegunungan Bintang
Bina	Puncak
Binakal	Bondowoso
Binamu	Jeneponto
Binangun	Cilacap
Binangun	Blitar
Binduriang	Rejang Lebong
Bingin Kuning	Lebong
Binjai	Langkat
Binjai Barat	Binjai
Binjai Hulu	Sintang
Binjai Kota	Binjai
Binjai Selatan	Binjai
Binjai Timur	Binjai
Binjai Utara	Binjai
Binong	Subang
Binongko	Wakatobi
Bintan Pesisir	Bintan
Bintan Timur	Bintan
Bintan Utara	Bintan
Bintang	Aceh Tengah
Bintang Ara	Tabalong
Bintang Bayu	Serdang Bedagai
Bintauna	Bolaang Mongondow Utara
Bintuni	Teluk Bintuni
Binuang	Polewali Mandar
Binuang	Tapin
Binuang	Serang
Birem Bayeun	Aceh Timur
Biringbulu	Gowa
Biringkanaya (Biring Kanaya)	Makassar
Biscoop	Teluk Bintuni
Bissappu	Bantaeng
Bittuang	Tana Toraja
Biuk	Tolikara
Blado	Batang
Blambangan Pagar	Lampung Utara
Blambangan Umpu	Way Kanan
Blanakan	Subang
Blang Bintang (Blank Bintang)	Aceh Besar
Blang Mangat	Lhokseumawe
Blang Pidie	Aceh Barat Daya
Blangjerango (Blang Jerango)	Gayo Lues
Blangkejeren (Blang Kejeren)	Gayo Lues
Blangpegayon (Blang Pegayon)	Gayo Lues
Blega	Bangkalan
Blimbing	Malang
Blimbingsari	Banyuwangi
Blora (Blora kota)	Blora
Blubur Limbangan	Garut
Bluluk	Lamongan
Bluto	Sumenep
Boawae	Nagekeo
Bobotsari	Purbalingga
Bodeh	Pemalang
Bogabaida (Bogobaida)	Paniai
Bogonuk	Tolikara
Bogor Barat	Bogor
Bogor Selatan	Bogor
Bogor Tengah	Bogor
Bogor Timur	Bogor
Bogor Utara	Bogor
Bogorejo	Blora
Boja	Kendal
Bojonegara	Serang
Bojonegoro	Bojonegoro
Bojong	Pandeglang
Bojong	Purwakarta
Bojong	Pekalongan
Bojong	Tegal
Bojong Gede (Bojonggede)	Bogor
Bojongasih	Tasikmalaya
Bojonggambir	Tasikmalaya
Bojonggenteng (Bojong Genteng)	Sukabumi
Bojongloa Kaler	Bandung
Bojongloa Kidul	Bandung
Bojongmangu	Bekasi
Bojongmanik	Lebak
Bojongpicung	Cianjur
Bojongsari	Purbalingga
Bojongsari	Depok
Bojongsoang	Bandung
Bokan Kepulauan	Banggai Laut
Bokat	Buol
Boking	Timor Tengah Selatan
Bokondini	Tolikara
Bokoneri	Tolikara
Bola	Sikka
Bola	Wajo
Bolaang	Bolaang Mongondow
Bolaang Timur	Bolaang Mongondow
Bolaang Uki	Bolaang Mongondow Selatan
Bolakme	Jayawijaya
Bolangitang Barat (Bolang Itang Barat)	Bolaang Mongondow Utara
Bolangitang Timur (Bolang Itang Timur)	Bolaang Mongondow Utara
Bolano	Parigi Moutong
Bolano Lambunu	Parigi Moutong
Boleng	Manggarai Barat
Boliohuto (Boliyohuto)	Gorontalo
Bolo	Bima
Bomakia	Boven Digoel
Bomberay	Fakfak
Bomela	Yahukimo
Bonai Darussalam	Rokan Hulu
Bonang	Demak
Bonatua Lunasi	Toba Samosir
Bondifuar	Biak Numfor
Bondoala	Konawe
Bondowoso	Bondowoso
Bone	Bone Bolango
Bone (Bone Tondo)	Muna
Bone Raya	Bone Bolango
Bone-Bone	Luwu Utara
Bonegunu	Buton Utara
Bonehau	Mamuju
Bonepantai	Bone Bolango
Bongan	Kutai Barat
Bongas	Indramayu
Bonggakaradeng	Tana Toraja
Bonggo	Sarmi
Bonggo Timur	Sarmi
Bongomeme	Gorontalo
Bonjol	Pasaman
Bonorowo	Kebumen
Bontang Barat	Bontang
Bontang Selatan	Bontang
Bontang Utara	Bontang
Bonti	Sanggau
Bonto Bahari	Bulukumba
Bonto Tiro (Bontotiro)	Bulukumba
Bontoa (Maros Utara)	Maros
Bontoala	Makassar
Bontocani	Bone
Bontoharu	Kepulauan Selayar
Bontolempangang	Gowa
Bontomanai	Kepulauan Selayar
Bontomarannu	Gowa
Bontomatene	Kepulauan Selayar
Bontonompo	Gowa
Bontonompo Selatan	Gowa
Bontoramba	Jeneponto
Bontosikuyu	Kepulauan Selayar
Borbor	Toba Samosir
Borme	Pegunungan Bintang
Borobudur	Magelang
Boronadu	Nias Selatan
Borong	Manggarai Timur
Bosar Maligas	Simalungun
Botain	Sorong
Botin Leobele	Malaka
Botolinggo	Bondowoso
Botomuzoi	Nias
Botumoita	Boalemo
Botupingge (Botu Pingge)	Bone Bolango
Bowobado	Deiyai
Boyan Tanjung	Kapuas Hulu
Boyolali	Boyolali
Boyolangu	Tulungagung
Bpiri	Jayawijaya
Braja Selebah (Braja Slebah)	Lampung Timur
Bram Itam	Tanjung Jabung Barat
Brang Ene	Sumbawa Barat
Brang Rea	Sumbawa Barat
Brangsong	Kendal
Brastagi (Berastagi)	Karo
Brati	Grobogan
Brebes	Brebes
Bringin	Semarang
Bringin	Ngawi
Brondong	Lamongan
Bruno	Purworejo
Bruwa	Lanny Jaya
Bruyadori	Biak Numfor
BTS Ulu	Musi Rawas
Bua	Luwu
Bua Ponrang (Bupon)	Luwu
Buahbatu (Margacinta)	Bandung
Buahdua	Sumedang
Bualemo (Boalemo)	Banggai
Buana Pemaca	Ogan Komering Ulu Selatan
Buaran	Pekalongan
Buay Bahuga	Way Kanan
Buay Madang	Ogan Komering Ulu Timur
Buay Madang Timur	Ogan Komering Ulu Timur
Buay Pemaca	Ogan Komering Ulu Selatan
Buay Pematang Ribu Ranau Tengah	Ogan Komering Ulu Selatan
Buay Pemuka Bangsa Raja	Ogan Komering Ulu Timur
Buay Pemuka Peliung	Ogan Komering Ulu Timur
Buay Rawan	Ogan Komering Ulu Selatan
Buay Runjung	Ogan Komering Ulu Selatan
Buay Sandang Aji	Ogan Komering Ulu Selatan
Buayan	Kebumen
Bubon	Aceh Barat
Bubulan	Bojonegoro
Bubutan	Surabaya
Budong-Budong	Mamuju Tengah
Buduran	Sidoarjo
Buer	Sumbawa
Bugi	Jayawijaya
Buguk Gona	Lanny Jaya
Bugul Kidul	Pasuruan
Buk	Sorong
Bukal	Buol
Bukateja	Purbalingga
Buke	Konawe Selatan
Buki	Kepulauan Selayar
Bukik Barisan	Lima Puluh Kota
Bukit	Bener Meriah
Bukit Batu	Palangka Raya
Bukit Batu	Bengkalis
Bukit Bestari	Tanjung Pinang
Bukit Kapur	Dumai
Bukit Kecil	Palembang
Bukit Kemuning	Lampung Utara
Bukit Malintang	Mandailing Natal
Bukit Raya	Katingan
Bukit Raya	Pekanbaru
Bukit Santuai (Bukit Santuei)	Kotawaringin Timur
Bukit Sundi	Solok
Bukit Tusam	Aceh Tenggara
Bukitintan (Bukit Intan)	Pangkal Pinang
Bukitkerman	Kerinci
Buko	Banggai Kepulauan
Buko Selatan	Banggai Kepulauan
Bula	Seram Bagian Timur
Bula Barat	Seram Bagian Timur
Bulagi	Banggai Kepulauan
Bulagi Selatan	Banggai Kepulauan
Bulagi Utara	Banggai Kepulauan
Bulak	Surabaya
Bulakamba	Brebes
Bulang	Batam
Bulango Selatan	Bone Bolango
Bulango Timur	Bone Bolango
Bulango Ulu	Bone Bolango
Bulango Utara	Bone Bolango
Bulawa	Bone Bolango
Buleleng	Buleleng
Bulik	Lamandau
Bulik Timur	Lamandau
Bulo	Polewali Mandar
Bulok	Tanggamus
Bulu	Rembang
Bulu	Sukoharjo
Bulu	Temanggung
Bulu Taba	Pasangkayu (Mamuju Utara)
Bulukerto	Wonogiri
Bulukumba (Bulukumpa)	Bulukumba
Bululawang	Malang
Bulupoddo	Sinjai
Buluspesantren	Kebumen
Bumi Agung	Lampung Timur
Bumi Agung	Way Kanan
Bumi Makmur	Tanah Laut
Bumi Nabung	Lampung Tengah
Bumi Ratu Nuban	Lampung Tengah
Bumi Raya	Morowali
Bumi Waras	Bandar Lampung
Bumiaji	Batu
Bumiayu	Brebes
Bumijawa	Tegal
Bunaken	Manado
Bunaken Kepulauan	Manado
Bunga Mas	Bengkulu Selatan
Bunga Mayang	Ogan Komering Ulu Timur
Bunga Mayang	Lampung Utara
Bunga Raya	Siak
Bungah	Gresik
Bungatan	Situbondo
Bungaya	Gowa
Bungbulang	Garut
Bungi	Bau-Bau
Bungin	Enrekang
Bungkal	Ponorogo
Bungku Barat	Morowali
Bungku Pesisir	Morowali
Bungku Selatan	Morowali
Bungku Tengah	Morowali
Bungku Timur	Morowali
Bungku Utara	Morowali Utara
Bungo Dani	Bungo
Bungoro	Pangkajene Kepulauan
Bungur	Tapin
Bunguran Barat	Natuna
Bunguran Batubi	Natuna
Bunguran Selatan	Natuna
Bunguran Tengah	Natuna
Bunguran Timur	Natuna
Bunguran Timur Laut	Natuna
Bunguran Utara	Natuna
Bungursari	Purwakarta
Bungursari	Tasikmalaya
Bungus Teluk Kabung	Padang
Bunobogu	Buol
Bunta	Banggai
Buntao	Toraja Utara
Buntu Batu	Enrekang
Buntu Pane	Asahan
Buntu Pepasan	Toraja Utara
Buntulia	Pohuwato
Buntumalangka	Mamasa
Bunut	Pelalawan
Bunut Hilir	Kapuas Hulu
Bunut Hulu	Kapuas Hulu
Bunyu (Pulau Bunyu)	Bulungan
Burau	Luwu Timur
Burneh	Bangkalan
Buru	Karimun
Buruway	Kaimana
Busang	Kutai Timur
Busung biu (Busungbiu)	Buleleng
Butuh	Purworejo
Buyasuri	Lembata
Cabangbungin	Bekasi
Cadasari	Pandeglang
Cakranegara	Mataram
Cakung	Jakarta Timur
Camba	Maros
Cambai	Prabumulih
Campaka	Cianjur
Campaka	Purwakarta
Campakamulya (Campaka Mulya)	Cianjur
Campalagian	Polewali Mandar
Camplong	Sampang
Campurdarat (Campur Darat)	Tulungagung
Candi	Sidoarjo
Candi Laras Selatan	Tapin
Candi Laras Utara	Tapin
Candimulyo	Magelang
Candipuro	Lumajang
Candipuro	Lampung Selatan
Candiroto	Temanggung
Candisari	Semarang
Candung	Agam
Cangkringan	Sleman
Cangkuang	Bandung
Cantigi	Indramayu
Capkala	Bengkayang
Carenang (Cerenang)	Serang
Caringin	Bogor
Caringin	Garut
Caringin	Sukabumi
Carita	Pandeglang
Cariu	Bogor
Catubouw	Pegunungan Arfak
Cawas	Klaten
Celala	Aceh Tengah
Cempa	Pinrang
Cempaga	Kotawaringin Timur
Cempaga Hulu	Kotawaringin Timur
Cempaka	Banjarbaru
Cempaka	Ogan Komering Ulu Timur
Cempaka Putih	Jakarta Pusat
Cendana	Enrekang
Cengal	Ogan Komering Ilir
Cengkareng	Jakarta Barat
Cenrana	Bone
Cenrana	Maros
Ceper	Klaten
Cepiring	Kendal
Cepogo	Boyolali
Cepu	Blora
Cerbon	Barito Kuala
Cerenti	Kuantan Singingi
Cerme	Gresik
Cermee	Bondowoso
Cermin Nan Gedang / Gadang	Sarolangun
Ciambar	Sukabumi
Ciamis	Ciamis
Ciampea	Bogor
Ciampel	Karawang
Cianjur	Cianjur
Ciasem	Subang
Ciater	Subang
Ciawi	Bogor
Ciawi	Tasikmalaya
Ciawigebang	Kuningan
Cibadak	Lebak
Cibadak	Sukabumi
Cibal	Manggarai
Cibal Barat	Manggarai
Cibaliung	Pandeglang
Cibalong	Garut
Cibalong	Tasikmalaya
Cibarusah	Bekasi
Cibatu	Garut
Cibatu	Purwakarta
Cibeber	Cilegon
Cibeber	Lebak
Cibeber	Cianjur
Cibeunying Kaler	Bandung
Cibeunying Kidul	Bandung
Cibeureum	Kuningan
Cibeureum	Sukabumi
Cibeureum	Tasikmalaya
Cibingbin	Kuningan
Cibinong	Bogor
Cibinong	Cianjur
Cibiru	Bandung
Cibitung	Pandeglang
Cibitung	Bekasi
Cibitung	Sukabumi
Cibiuk	Garut
Cibodas	Tangerang
Cibogo	Subang
Cibuaya	Karawang
Cibugel	Sumedang
Cibungbulang	Bogor
Cicalengka	Bandung
Cicantayan	Sukabumi
Cicendo	Bandung
Cicurug	Sukabumi
Cidadap	Bandung
Cidadap	Sukabumi
Cidahu	Kuningan
Cidahu	Sukabumi
Cidaun	Cianjur
Cidolog	Ciamis
Cidolog	Sukabumi
Ciemas	Sukabumi
Cigalontang	Tasikmalaya
Cigandamekar	Kuningan
Cigasong	Majalengka
Cigedug	Garut
Cigemlong (Cigemblong)	Lebak
Cigeulis	Pandeglang
Cigombong	Bogor
Cigudeg	Bogor
Cigugur	Pangandaran
Cigugur	Kuningan
Cihampelas	Bandung Barat
Cihara	Lebak
Cihaurbeuti	Ciamis
Cihideung	Tasikmalaya
Cihurip	Garut
Cijaku	Lebak
Cijambe	Subang
Cijati	Cianjur
Cijeruk	Bogor
Cijeungjing	Ciamis
Cijulang	Pangandaran
Cikadu	Cianjur
Cikajang	Garut
Cikakak	Sukabumi
Cikalong	Tasikmalaya
Cikalongkulon	Cianjur
Cikalongwetan (Cikalong Wetan)	Bandung Barat
Cikampek	Karawang
Cikancung	Bandung
Cikande	Serang
Cikarang Barat	Bekasi
Cikarang Pusat	Bekasi
Cikarang Selatan	Bekasi
Cikarang Timur	Bekasi
Cikarang Utara	Bekasi
Cikatomas	Tasikmalaya
Cikaum	Subang
Cikedung	Indramayu
Cikelet	Garut
Cikembar	Sukabumi
Cikeudal (Cikedal)	Pandeglang
Cikeusal	Serang
Cikeusik	Pandeglang
Cikidang	Sukabumi
Cikijing	Majalengka
Cikole	Sukabumi
Cikoneng	Ciamis
Cikulur	Lebak
Cikupa	Tangerang
Cilacap Selatan	Cilacap
Cilacap Tengah	Cilacap
Cilacap Utara	Cilacap
Cilaku	Cianjur
Cilamaya Kulon	Karawang
Cilamaya Wetan	Karawang
Cilandak	Jakarta Selatan
Cilawu	Garut
Cilebak	Kuningan
Cilebar	Karawang
Ciledug	Tangerang
Ciledug	Cirebon
Cilegon	Cilegon
Cileles	Lebak
Cilengkrang	Bandung
Cileungsi	Bogor
Cileunyi	Bandung
Cililin	Bandung Barat
Cilimus	Kuningan
Cilincing	Jakarta Utara
Cilodong	Depok
Cilograng	Lebak
Cilongok	Banyumas
Cimahi	Kuningan
Cimahi Selatan	Cimahi
Cimahi Tengah	Cimahi
Cimahi Utara	Cimahi
Cimalaka	Sumedang
Cimanggis	Depok
Cimanggu	Pandeglang
Cimanggu	Sukabumi
Cimanggu	Cilacap
Cimanggung	Sumedang
Cimanuk	Pandeglang
Cimaragas	Ciamis
Cimarga	Lebak
Cimaung	Bandung
Cimenyan (Cimeunyan)	Bandung
Cimerak	Pangandaran
Cina	Bone
Cinambo	Bandung
Cinangka	Serang
Cineam	Tasikmalaya
Cinere	Depok
Cingambul	Majalengka
Ciniru	Kuningan
Cintapuri Darussalam	Banjar
Ciomas	Serang
Ciomas	Bogor
Cipaku	Ciamis
Cipanas	Lebak
Cipanas	Cianjur
Ciparay	Bandung
Cipari	Cilacap
Cipatat	Bandung Barat
Cipatujah	Tasikmalaya
Cipayung	Jakarta Timur
Cipayung	Depok
Cipedes	Tasikmalaya
Cipeucang	Pandeglang
Cipeundeuy	Bandung Barat
Cipeundeuy	Subang
Cipicung	Kuningan
Cipocok Jaya	Serang
Cipondoh	Tangerang
Cipongkor	Bandung Barat
Cipunagara	Subang
Ciputat	Tangerang Selatan
Ciputat Timur	Tangerang Selatan
Ciracap	Sukabumi
Ciracas	Jakarta Timur
Ciranjang	Cianjur
Cireunghas	Sukabumi
Cirinten	Lebak
Ciruas	Serang
Cisaat	Sukabumi
Cisaga	Ciamis
Cisalak	Subang
Cisarua	Bandung Barat
Cisarua	Bogor
Cisarua	Sumedang
Cisata	Pandeglang
Cisauk	Tangerang
Cisayong	Tasikmalaya
Ciseeng	Bogor
Cisewu	Garut
Cisitu	Sumedang
Cisoka	Tangerang
Cisolok	Sukabumi
Cisompet	Garut
Cisurupan	Garut
Citak-Mitak (Citakmitak)	Mappi
Citamiang	Sukabumi
Citangkil	Cilegon
Citeureup	Bogor
Citta	Soppeng
Ciwandan	Cilegon
Ciwaringin	Cirebon
Ciwaru	Kuningan
Ciwidey	Bandung
Cluring	Banyuwangi
Cluwak	Pati
Coblong	Bandung
Colomadu	Karanganyar
Comal	Pemalang
Compreng	Subang
Concong	Indragiri Hilir
Conggeang	Sumedang
Cot Girek	Aceh Utara
Cugenang	Cianjur
Cukuh Balak	Tanggamus
Culamega	Tasikmalaya
Curahdami	Bondowoso
Curio	Enrekang
Curug	Serang
Curug	Tangerang
Curug bitung (Curugbitung)	Lebak
Curugkembar	Sukabumi
Curup	Rejang Lebong
Curup Selatan	Rejang Lebong
Curup Tengah	Rejang Lebong
Curup Timur	Rejang Lebong
Curup Utara	Rejang Lebong
Dabun Gelang (Debun Gelang)	Gayo Lues
Dadahup	Kapuas
Dagai	Puncak Jaya
Dagangan	Madiun
Daha Barat	Hulu Sungai Selatan
Daha Selatan	Hulu Sungai Selatan
Daha Utara	Hulu Sungai Selatan
Dako Pemean (Dako Pamean)	Toli-Toli
Dal	Nduga
Damai	Kutai Barat
Damang Batu	Gunung Mas
Damao (Damau)	Kepulauan Talaud
Damar	Belitung Timur
Damer	Maluku Barat Daya
Dampal Selatan	Toli-Toli
Dampal Utara	Toli-Toli
Dampelas	Donggala
Dampit	Malang
Danau Kembar	Solok
Danau Kerinci	Kerinci
Danau Panggang	Hulu Sungai Utara
Danau Paris	Aceh Singkil
Danau Seluluk	Seruyan
Danau Sembuluh	Seruyan
Danau Sipin	Jambi
Danau Teluk	Jambi
Dander	Bojonegoro
Dangia	Kolaka Timur
Danime	Tolikara
Danurejan	Yogyakarta
Dapurang	Pasangkayu (Mamuju Utara)
Darangdan	Purwakarta
Darma	Kuningan
Darmaraja	Sumedang
Darul Aman	Aceh Timur
Darul Falah	Aceh Timur
Darul Hasanah	Aceh Tenggara
Darul Hikmah	Aceh Jaya
Darul Iksan (Ihsan)	Aceh Timur
Darul Imarah	Aceh Besar
Darul Kamal	Aceh Besar
Darul Makmur	Nagan Raya
Darussalam	Aceh Besar
Dasuk	Sumenep
Dataran Beimes	Teluk Bintuni
Dataran Isim	Manokwari Selatan
Datuk Bandar	Tanjung Balai
Datuk Bandar Timur	Tanjung Balai
Datuk Lima Puluh	Batu Bara
Datuk Tanah Datar	Batu Bara
Dau	Malang
Dawan	Klungkung
Dawarblandong (Dawar Blandong)	Mojokerto
Dawe	Kudus
Dawelor Dawera	Maluku Barat Daya
Dawuan	Majalengka
Dawuan	Subang
Dayeuhkolot	Bandung
Dayeuhluhur	Cilacap
Dayun	Siak
Dedai	Sintang
Deiyai Miyo	Paniai
Dekai	Yahukimo
Deket	Lamongan
Delang	Lamandau
Delanggu	Klaten
Deleng Pokhkisen (Deleng Pokhisen)	Aceh Tenggara
Deli Tua	Deli Serdang
Delima	Pidie
Delta Pawan	Ketapang
Demak	Demak
Demba	Waropen
Demon Pagong	Flores Timur
Dempet	Demak
Dempo Selatan	Pagar Alam
Dempo Tengah	Pagar Alam
Dempo Utara	Pagar Alam
Demta	Jayapura
Dendang	Belitung Timur
Dendang	Tanjung Jabung Timur
Dende' Piongan Napo	Toraja Utara
Dengilo	Pohuwato
Denpasar Barat	Denpasar
Denpasar Selatan	Denpasar
Denpasar Timur	Denpasar
Denpasar Utara	Denpasar
Dente Teladas	Tulang Bawang
Depapre	Jayapura
Depati Tujuh	Kerinci
Depok	Sleman
Depok	Cirebon
Der Koumur	Asmat
Dervos	Puncak
Detukeli	Ende
Detusoko	Ende
Dewantara	Aceh Utara
Didohu	Pegunungan Arfak
Dimba	Lanny Jaya
Dimembe	Minahasa Utara
Dipa	Nabire
Dirwemna (Diruwena)	Yahukimo
Diwek	Jombang
Dlanggu	Mojokerto
Dlingo	Bantul
Dogiyai	Dogiyai
Dogomo	Paniai
Doko	Blitar
Dokome	Puncak Jaya
Dolat Rayat	Karo
Dolo	Sigi
Dolo Barat	Sigi
Dolo Selatan	Sigi
Dolog Masagal	Simalungun
Dolok	Padang Lawas Utara
Dolok Batu Nanggar	Simalungun
Dolok Masihul	Serdang Bedagai
Dolok Merawan	Serdang Bedagai
Dolok Panribuan	Simalungun
Dolok Pardamean	Simalungun
Dolok Sanggul	Humbang Hasundutan
Dolok Sigompulon	Padang Lawas Utara
Dolok Silau	Simalungun
Dolopo	Madiun
Dompu	Dompu
Dondo	Toli-Toli
Donggo	Bima
Dongko	Trenggalek
Donomulyo	Malang
Donorojo	Pacitan
Donorojo	Jepara
Donri-Donri	Soppeng
Doreng	Sikka
Doro	Pekalongan
Doufo	Puncak
Dow	Tolikara
Dramaga	Bogor
Dringu	Probolinggo
Driyorejo	Gresik
Dua Boccoe	Bone
Dua Pitue	Sidenreng Rappang
Duampanua	Pinrang
Duduksampeyan (Duduk Sampeyan)	Gresik
Duhiadaa	Pohuwato
Dukuh Pakis	Surabaya
Dukuhseti	Pati
Dukuhturi	Tegal
Dukuhwaru	Tegal
Dukun	Magelang
Dukun	Gresik
Dukupuntang	Cirebon
Dulupi	Boalemo
Dumadama	Paniai
Dumai Barat	Dumai
Dumai Kota	Dumai
Dumai Selatan	Dumai
Dumai Timur	Dumai
Dumbo Raya	Gorontalo
Dumoga	Bolaang Mongondow
Dumoga Barat	Bolaang Mongondow
Dumoga Tengah	Bolaang Mongondow
Dumoga Tenggara	Bolaang Mongondow
Dumoga Timur	Bolaang Mongondow
Dumoga Utara	Bolaang Mongondow
Dundu (Ndundu)	Tolikara
Dungaliyo	Gorontalo
Dungingi	Gorontalo
Dungkek	Sumenep
Duo Koto	Pasaman
Durai	Karimun
Duram	Yahukimo
Duren Sawit	Jakarta Timur
Durenan	Trenggalek
Duripoku	Pasangkayu (Mamuju Utara)
Duruka	Muna
Dusun Hilir	Barito Selatan
Dusun Selatan	Barito Selatan
Dusun Tengah	Barito Timur
Dusun Timur	Barito Timur
Dusun Utara	Barito Selatan
Ebungfao (Ebungfau / Ebungfa)	Jayapura
Edera	Mappi
Egiam	Tolikara
Eipumek	Pegunungan Bintang
Ekadide	Paniai
Elar	Manggarai Timur
Elar Selatan	Manggarai Timur
Elelim	Yalimo
Elikobal	Merauke
Ella Hilir	Melawi
Elpaputih	Seram Bagian Barat
Embaloh Hilir	Kapuas Hulu
Embaloh Hulu	Kapuas Hulu
Embetpen	Nduga
Empanang	Kapuas Hulu
Empang	Sumbawa
Empat Petulai Dangku	Muara Enim
Enam Lingkung	Padang Pariaman
Ende	Ende
Ende Selatan	Ende
Ende Tengah	Ende
Ende Timur	Ende
Ende Utara	Ende
Endomen	Yahukimo
Enggal	Bandar Lampung
Enggano	Bengkulu Utara
Enok	Indragiri Hilir
Enrekang	Enrekang
Entikong	Sanggau
Eragayam	Mamberamo Tengah
Erelmakawia	Puncak
Eremerasa	Bantaeng
Eris	Minahasa
Eromoko	Wonogiri
Essang	Kepulauan Talaud
Essang Selatan	Kepulauan Talaud
Fafurwar (Irorutu)	Teluk Bintuni
Fak-Fak (Fakfak)	Fakfak
Fak-Fak Barat (Fakfak Barat)	Fakfak
Fak-Fak Tengah (Fakfak Tengah)	Fakfak
Fak-Fak Timur (Fakfak Timur)	Fakfak
Fakfak Timur Tengah	Fakfak
Fanayama	Nias Selatan
Fatukopa	Timor Tengah Selatan
Fatuleu	Kupang
Fatuleu Barat	Kupang
Fatuleu Tengah	Kupang
Fatumnasi	Timor Tengah Selatan
Fautmolo	Timor Tengah Selatan
Fawi	Puncak Jaya
Fayit	Asmat
Fef	Tambrauw
Fena Fafan	Buru Selatan
Fena Leisela	Buru
Firiwage	Boven Digoel
Fofi	Boven Digoel
Fokour	Sorong Selatan
Furwagi	Fakfak
Gabek	Pangkal Pinang
Gabus	Grobogan
Gabus	Pati
Gabuswetan	Indramayu
Gading	Probolinggo
Gading Cempaka	Bengkulu
Gading Rejo	Pringsewu
Gadingrejo	Pasuruan
Gadung	Buol
Gajah	Demak
Gajah Putih	Bener Meriah
Gajahmungkur (Gajah Mungkur)	Semarang
Galang	Deli Serdang
Galang	Toli-Toli
Galang	Batam
Galela	Halmahera Utara
Galela Barat	Halmahera Utara
Galela Selatan	Halmahera Utara
Galela Utara	Halmahera Utara
Galesong	Takalar
Galesong Selatan	Takalar
Galesong Utara	Takalar
Galing	Sambas
Galis	Pamekasan
Galis	Bangkalan
Galur	Kulon Progo
Gambir	Jakarta Pusat
Gambiran	Banyuwangi
Gambut	Banjar
Gamelia	Lanny Jaya
Gampengrejo	Kediri
Gamping	Sleman
Gandangbatu Sillanan (Gandang Batu Sillanan)	Tana Toraja
Gandapura (Ganda Pura)	Bireuen
Ganding	Sumenep
Gandrungmangu	Cilacap
Gandus	Palembang
Gandusari	Trenggalek
Gandusari	Blitar
Gane Barat	Halmahera Selatan
Gane Barat Selatan	Halmahera Selatan
Gane Barat Utara	Halmahera Selatan
Gane Timur	Halmahera Selatan
Gane Timur Selatan	Halmahera Selatan
Gane Timur Tengah	Halmahera Selatan
Ganeas	Sumedang
Gangga	Lombok Utara
Ganra	Soppeng
Gantar	Indramayu
Gantarang Keke (Gantareng Keke)	Bantaeng
Gantiwarno	Klaten
Gantorang/Gantarang (Gangking)	Bulukumba
Gantung	Belitung Timur
Gapura	Sumenep
Garawangi	Kuningan
Garoga	Tapanuli Utara
Garum	Blitar
Garung	Wonosobo
Garut Kota	Garut
Gatak	Sukoharjo
Gaung	Indragiri Hilir
Gaung Anak Serka	Indragiri Hilir
Gayam	Bojonegoro
Gayam	Sumenep
Gayamsari	Semarang
Gayungan	Surabaya
Gearek	Nduga
Gebang	Langkat
Gebang	Cirebon
Gebang	Purworejo
Gebog	Kudus
Gedangan	Malang
Gedangan	Sidoarjo
Gedangsari (Gedang Sari)	Gunung Kidul
Gedebage	Bandung
Gedeg	Mojokerto
Gedong Tataan	Pesawaran
Gedongtengen (Gedong Tengen)	Yogyakarta
Gedung Aji	Tulang Bawang
Gedung Aji Baru	Tulang Bawang
Gedung Meneng	Tulang Bawang
Gedung Surian	Lampung Barat
Geger	Madiun
Geger	Bangkalan
Gegerbitung (Geger Bitung)	Sukabumi
Gegesik	Cirebon
Gekbrong	Cianjur
Gelok Beam	Lanny Jaya
Gelumbang	Muara Enim
Gemarang	Madiun
Gemawang	Temanggung
Gembong	Pati
Gemeh	Kepulauan Talaud
Gemolong	Sragen
Gempol	Cirebon
Gempol	Pasuruan
Gemuh	Kendal
Gending	Probolinggo
Geneng	Ngawi
Genteng	Surabaya
Genteng	Banyuwangi
Gentuma Raya	Gorontalo Utara
Genuk	Semarang
Geragai	Tanjung Jabung Timur
Gerih	Ngawi
Gerogol	Cilegon
Gerokgak	Buleleng
Gerung	Lombok Barat
Gerunggang	Pangkal Pinang
Geselma (Geselema)	Nduga
Gesi	Sragen
Getasan	Semarang
Geulumpang Tiga	Pidie
Geumpang	Pidie
Geuredong Pase	Aceh Utara
Geya	Tolikara
Geyer	Grobogan
Gianyar	Gianyar
Gido	Nias
Gika	Tolikara
Giliginting (Gili Ginting)	Sumenep
Gilireng	Wajo
Gilubandu (Gilumbandu/Gilimbandu)	Tolikara
Giri	Banyuwangi
Giri Mulia (Giri Mulya)	Bengkulu Utara
Girian	Bitung
Girimarto	Wonogiri
Girimaya	Pangkal Pinang
Girimulyo	Kulon Progo
Girisubo	Gunung Kidul
Giritontro	Wonogiri
Giriwoyo	Wonogiri
Girsang Sipangan Bolon	Simalungun
Gisting	Tanggamus
Gladagsari	Boyolali
Glagah	Banyuwangi
Glagah	Lamongan
Glenmore	Banyuwangi
Glumpang Baro	Pidie
Goa Balim	Lanny Jaya
Godean	Sleman
Godong	Grobogan
Golewa	Ngada
Golewa Barat	Ngada
Golewa Selatan	Ngada
Gollo	Lanny Jaya
Gombong	Kebumen
Gome	Puncak
Gome Utara	Puncak
Gomo	Nias Selatan
Gondang	Sragen
Gondang	Bojonegoro
Gondang	Mojokerto
Gondang	Nganjuk
Gondang	Tulungagung
Gondanglegi	Malang
Gondangrejo	Karanganyar
Gondangwetan (Gondang Wetan)	Pasuruan
Gondokusuman	Yogyakarta
Gondomanan	Yogyakarta
Gorom Timur	Seram Bagian Timur
Goyage	Tolikara
Grabag	Magelang
Grabag	Purworejo
Grabagan	Tuban
Grati	Pasuruan
Greged (Greget)	Cirebon
Gresi Selatan	Jayapura
Gresik	Gresik
Gringsing	Batang
Grobogan	Grobogan
Grogol	Sukoharjo
Grogol	Kediri
Grogol Petamburan	Jakarta Barat
Grong Grong	Pidie
Grujugan	Bondowoso
Gu	Buton Tengah
Gubeng	Surabaya
Gubug	Grobogan
Gubume	Puncak Jaya
Gucialit	Lumajang
Gudo	Jombang
Guguak (Gugu)	Lima Puluh Kota
Guguk Panjang (Guguak Panjang)	Bukittinggi
Guluk-Guluk (Guluk Guluk)	Sumenep
Gumay Talang	Lahat
Gumay Ulu	Lahat
Gumbasa	Sigi
Gumelar	Banyumas
Gumukmas (Gumuk Mas)	Jember
Guna	Lanny Jaya
Gundagi (Gudage)	Tolikara
Gunem	Rembang
Guntur	Demak
Gunuang Omeh (Gunung Mas)	Lima Puluh Kota
Gunung Agung	Tulang Bawang Barat
Gunung Alip	Tanggamus
Gunung Anyar (Gununganyar)	Surabaya
Gunung Bintang Awai	Barito Selatan
Gunung Jati (Cirebon Utara)	Cirebon
Gunung Kaler	Tangerang
Gunung Kerinci	Kerinci
Gunung Kijang	Bintan
Gunung Labuhan	Way Kanan
Gunung Malela	Simalungun
Gunung Maligas	Simalungun
Gunung Megang	Muara Enim
Gunung Meriah	Deli Serdang
Gunung Meriah (Mariah)	Aceh Singkil
Gunung Pelindung	Lampung Timur
Gunung Purei	Barito Utara
Gunung Putri	Bogor
Gunung Raya	Kerinci
Gunung Sahilan	Kampar
Gunung Sari (Gunungsari)	Serang
Gunung Sindur	Bogor
Gunung Sitember	Dairi
Gunung Sugih	Lampung Tengah
Gunung Tabur	Berau
Gunung Talang	Solok
Gunung Tanjung	Tasikmalaya
Gunung Terang	Tulang Bawang Barat
Gunung Timang	Barito Utara
Gunung Tujuh	Kerinci
Gunungguruh	Sukabumi
Gununghalu	Bandung Barat
Gunungkencana (Gunung Kencana)	Lebak
Gunungpati	Semarang
Gunungpuyuh (Gunung Puyuh)	Sukabumi
Gunungsari	Lombok Barat
Gunungsitoli	Gunungsitoli
Gunungsitoli Alo'oa	Gunungsitoli
Gunungsitoli Barat	Gunungsitoli
Gunungsitoli Idanoi	Gunungsitoli
Gunungsitoli Selatan	Gunungsitoli
Gunungsitoli Utara	Gunungsitoli
Gunungtoar (Gunung Toar)	Kuantan Singingi
Gunungtuleh (Gunung Tuleh)	Pasaman Barat
Gunungwungkal	Pati
Gupura	Lanny Jaya
Gurage	Puncak Jaya
Gurah	Kediri
Habinsaran	Toba Samosir
Haharu	Sumba Timur
Haju	Mappi
Halong	Balangan
Halongonan	Padang Lawas Utara
Halongonan Timur	Padang Lawas Utara
Hampang	Kotabaru
Hamparan Perak	Deli Serdang
Hamparan Rawang	Sungaipenuh
Hanau	Seruyan
Hantakan	Hulu Sungai Tengah
Hantara	Kuningan
Haranggaol Horison	Simalungun
Harau	Lima Puluh Kota
Harian	Samosir
Harjamukti	Cirebon
Haruai	Tabalong
Haruyan	Hulu Sungai Tengah
Hatonduhan	Simalungun
Hatungun	Tapin
Haur Gading	Hulu Sungai Utara
Haurgeulis	Indramayu
Haurwangi	Cianjur
Hawu Mehara	Sabu Raijua
Helumo	Bolaang Mongondow Selatan
Heram	Jayapura
Hereapini (Hereanini)	Yahukimo
Hero Lange Lange (Herlang)	Bulukumba
Hewokloang	Sikka
Hibala	Nias Selatan
Hiliduho	Nias
Hilimegai	Nias Selatan
Hilipuk	Yahukimo
Hiliran Gumanti	Solok
Hilisalawa'ahe (Hilisalawaahe)	Nias Selatan
Hiliserangkai (Hili Serangkai / Hilisaranggu)	Nias
Hinai	Langkat
Hingk	Pegunungan Arfak
Hitadipa	Intan Jaya
Hoat Sorbay	Maluku Tenggara
Hobard	Sorong
Hogio (Hugio)	Yahukimo
Holuon	Yahukimo
Homeyo	Intan Jaya
Hoya	Mimika
Hu'u	Dompu
Huamual	Seram Bagian Barat
Huamual Belakang	Seram Bagian Barat
Hubikiak	Jayawijaya
Hubikosi (Hobikosi)	Jayawijaya
Hulonthalangi	Gorontalo
Hulu Gurung	Kapuas Hulu
Hulu Kuantan	Kuantan Singingi
Hulu Palik	Bengkulu Utara
Hulu Sihapas	Padang Lawas Utara
Hulu Sungai	Ketapang
Hulu Sungkai	Lampung Utara
Huristak	Padang Lawas
Huruna	Nias Selatan
Huta Bargot	Mandailing Natal
Huta Bayu Raja	Simalungun
Huta Raja Tinggi	Padang Lawas
Ibele	Jayawijaya
Ibu	Halmahera Barat
Ibu Selatan	Halmahera Barat
Ibu Utara	Halmahera Barat
Ibun	Bandung
Idanogawo (Idano Gawo)	Nias
Idanotae	Nias Selatan
Idi Rayeuk	Aceh Timur
Idi Timur	Aceh Timur
Idi Tunong	Aceh Timur
Ilaga	Puncak
Ilaga Utara	Puncak
Ilamburawi	Puncak Jaya
Ile Ape	Lembata
Ile Ape Timur	Lembata
Ile Boleng	Flores Timur
Ile Bura	Flores Timur
Ile Mandiri	Flores Timur
Ilir Barat I	Palembang
Ilir Barat II	Palembang
Ilir Talo	Seluma
Ilir Timur I	Palembang
Ilir Timur II	Palembang
Ilir Timur Tiga	Palembang
Ilu	Puncak Jaya
Ilugwa	Mamberamo Tengah
Ilwayab (Ilyawab)	Merauke
Imogiri	Bantul
Inamosol	Seram Bagian Barat
Inanwatan	Sorong Selatan
Indihiang	Tasikmalaya
Indra Jaya	Aceh Jaya
Indra Jaya	Pidie
Indra Makmu (Indra Makmur)	Aceh Timur
Indralaya	Ogan Ilir
Indralaya Selatan	Ogan Ilir
Indralaya Utara	Ogan Ilir
Indramayu	Indramayu
Indrapuri	Aceh Besar
Inerie	Ngada
Inggerus	Waropen
Ingin Jaya	Aceh Besar
Inikgal	Nduga
Iniyandit	Boven Digoel
Iniye	Nduga
Insana	Timor Tengah Utara
Insana Barat	Timor Tengah Utara
Insana Fafinesu	Timor Tengah Utara
Insana Tengah	Timor Tengah Utara
Insana Utara	Timor Tengah Utara
Inuman	Kuantan Singingi
Io Kufeu	Malaka
Ipuh (Muko Muko Selatan)	Muko Muko
Ireres	Tambrauw
Irimuli	Puncak Jaya
Itlay Hisage	Jayawijaya
IV Angkat Candung (Ampek Angkek)	Agam
IV Jurai	Pesisir Selatan
IV Koto (Ampek Koto)	Agam
IV Koto Aur Malintang	Padang Pariaman
IV Nagari	Sijunjung
IV Nagari Bayang Utara	Pesisir Selatan
Iwaka	Mimika
Iwoimendaa	Kolaka
Iwur (Okiwur)	Pegunungan Bintang
IX Koto Sungai Lasi	Solok
Jabiren (Jabiren Raya)	Pulang Pisau
Jabon	Sidoarjo
Jabung	Malang
Jabung	Lampung Timur
Jagakarsa	Jakarta Selatan
Jagebob	Merauke
Jagoi Babang	Bengkayang
Jagong Jeget	Aceh Tengah
Jailolo	Halmahera Barat
Jailolo Selatan	Halmahera Barat
Jair	Boven Digoel
Jakabaring	Palembang
Jaken	Pati
Jakenan	Pati
Jalaksana	Kuningan
Jalancagak	Subang
Jamanis	Tasikmalaya
Jambangan	Surabaya
Jambe	Tangerang
Jambesari / Jambe Sari Darus Sholah	Bondowoso
Jambi Luar Kota	Muaro Jambi
Jambi Selatan	Jambi
Jambi Timur	Jambi
Jamblang	Cirebon
Jambon	Ponorogo
Jambu	Semarang
Jampangkulon (Jampang Kulon)	Sukabumi
Jampangtengah (Jampang Tengah)	Sukabumi
Janapria	Lombok Tengah
Jangka	Bireuen
Jangka Buaya (Jangka Buya)	Pidie Jaya
Jangkang	Sanggau
Jangkar	Situbondo
Jangkat	Merangin
Jangkat Timur (Sungai Tenang)	Merangin
Japah	Blora
Japara	Kuningan
Jarai	Lahat
Jaro	Tabalong
Jasinga	Bogor
Jaten	Karanganyar
Jati	Blora
Jati	Kudus
Jati Agung	Lampung Selatan
Jatiasih	Bekasi
Jatibanteng	Situbondo
Jatibarang	Indramayu
Jatibarang	Brebes
Jatigede	Sumedang
Jatikalen	Nganjuk
Jatilawang	Banyumas
Jatiluhur	Purwakarta
Jatinagara	Ciamis
Jatinangor	Sumedang
Jatinegara	Jakarta Timur
Jatinegara	Tegal
Jatinom	Klaten
Jatinunggal	Sumedang
Jatipurno	Wonogiri
Jatipuro	Karanganyar
Jatirejo	Mojokerto
Jatirogo	Tuban
Jatiroto	Lumajang
Jatiroto	Wonogiri
Jatisampurna (Jati Sampurna)	Bekasi
Jatisari	Karawang
Jatisrono	Wonogiri
Jatitujuh	Majalengka
Jatiuwung	Tangerang
Jatiwangi	Majalengka
Jatiwaras	Tasikmalaya
Jatiyoso	Karanganyar
Jawa Maraja Bah Jambi	Simalungun
Jawai	Sambas
Jawai Selatan	Sambas
Jawilan	Serang
Jaya	Aceh Jaya
Jaya Baru	Banda Aceh
Jayakerta	Karawang
Jayaloka (Jaya Loka)	Musi Rawas
Jayanti	Tangerang
Jayapura	Ogan Komering Ulu Timur
Jayapura Selatan	Jayapura
Jayapura Utara	Jayapura
Jebres	Surakarta
Jebus	Bangka Barat
Jejangkit	Barito Kuala
Jejawi	Ogan Komering Ilir
Jekan Raya	Palangka Raya
Jekulo	Kudus
Jelai	Sukamara
Jelai Hulu	Ketapang
Jelbuk	Jember
Jelimpo	Landak
Jelutung	Jambi
Jemaja	Kepulauan Anambas
Jemaja Barat	Kepulauan Anambas
Jemaja Timur	Kepulauan Anambas
Jembrana	Jembrana
Jempang	Kutai Barat
Jenamas	Barito Selatan
Jenangan	Ponorogo
Jenar	Sragen
Jenawi	Karanganyar
Jenggawah	Jember
Jenu	Tuban
Jepara	Jepara
Jepon	Blora
Jerebuu	Ngada
Jereweh	Sumbawa Barat
Jerowaru	Lombok Timur
Jeruklegi	Cilacap
Jetfa	Pegunungan Bintang
Jetis	Bantul
Jetis	Yogyakarta
Jetis	Mojokerto
Jetis	Ponorogo
Jetsy	Asmat
Jeumpa	Aceh Barat Daya
Jeumpa	Bireuen
Jeunieb	Bireuen
Jiken	Blora
Jila	Mimika
Jiput	Pandeglang
Jirak Jaya	Musi Banyuasin
Jita	Mimika
Jiwan	Madiun
Joerat	Asmat
Jogonalan	Klaten
Jogorogo	Ngawi
Jogoroto	Jombang
Johan Pahwalan (Johan Pahlawan)	Aceh Barat
Johar Baru	Jakarta Pusat
Jombang	Cilegon
Jombang	Jember
Jombang	Jombang
Jonggat	Lombok Tengah
Jonggol	Bogor
Jongkong (Jengkong)	Kapuas Hulu
Jorlang Hataran	Simalungun
Jorong	Tanah Laut
Jrengik	Sampang
Juai	Balangan
Juhar	Karo
Jujuhan	Bungo
Jujuhan Ilir	Bungo
Juli	Bireuen
Julok	Aceh Timur
Jumantono	Karanganyar
Jumapolo	Karanganyar
Jumo	Temanggung
Junjung Sirih	Solok
Junrejo	Batu
Juntinyuat	Indramayu
Juwana	Pati
Juwangi	Boyolali
Juwiring	Klaten
Kabaena	Bombana
Kabaena Barat	Bombana
Kabaena Selatan	Bombana
Kabaena Tengah	Bombana
Kabaena Timur	Bombana
Kabaena Utara	Bombana
Kabandungan	Sukabumi
Kabangka	Muna
Kabanjahe	Karo
Kabaruan	Kepulauan Talaud
Kabat	Banyuwangi
Kabawo	Muna
Kabianggama (Kabianggema)	Yahukimo
Kabila	Bone Bolango
Kabila Bone	Bone Bolango
Kabola	Alor
Kabuh	Jombang
Kabun	Rokan Hulu
Kadatua	Buton Selatan
Kademangan	Probolinggo
Kademangan	Blitar
Kadia	Kendari
Kadipaten	Majalengka
Kadipaten	Tasikmalaya
Kadudampit	Sukabumi
Kadugede	Kuningan
Kaduhejo	Pandeglang
Kadungora	Garut
Kadupandak	Cianjur
Kadur	Pamekasan
Kahaunguweti (Kahaungu Eti)	Sumba Timur
Kahayan Hilir	Pulang Pisau
Kahayan Hulu Utara	Gunung Mas
Kahayan Kuala	Pulang Pisau
Kahayan Tengah	Pulang Pisau
Kahu	Bone
Kai	Tolikara
Kaibar	Mappi
Kaidipang	Bolaang Mongondow Utara
Kaimana	Kaimana
Kairatu	Seram Bagian Barat
Kairatu Barat	Seram Bagian Barat
Kais	Sorong Selatan
Kais Darat	Sorong Selatan
Kaisenar	Keerom
Kaitaro	Teluk Bintuni
Kajang	Bulukumba
Kajen	Pekalongan
Kajoran	Magelang
Kajuara	Bone
Kakas	Minahasa
Kakas Barat	Minahasa
Kakuluk Mesak	Belu
Kalaena	Luwu Timur
Kalanganyar	Lebak
Kalapanunggal (Kalapa Nunggal)	Sukabumi
Kalasan	Sleman
Kalawat	Minahasa Utara
Kaledupa	Wakatobi
Kaledupa Selatan	Wakatobi
Kalianda	Lampung Selatan
Kalianget	Sumenep
Kaliangkrik	Magelang
Kalibagor	Banyumas
Kalibaru	Banyuwangi
Kalibawang	Kulon Progo
Kalibawang	Wonosobo
Kalibening	Banjarnegara
Kalibunder	Sukabumi
Kalidawir	Tulungagung
Kalideres	Jakarta Barat
Kalidoni	Palembang
Kaligesing	Purworejo
Kaligondang	Purbalingga
Kalijambe	Sragen
Kalijati	Subang
Kalikajar	Wonosobo
Kalikotes	Klaten
Kalimanah	Purbalingga
Kalimanggis	Kuningan
Kalinyamatan	Jepara
Kaliorang	Kutai Timur
Kaliori	Rembang
Kalipare	Malang
Kalipucang	Pangandaran
Kalipuro	Banyuwangi
Kalirejo	Lampung Tengah
Kalis	Kapuas Hulu
Kalisat	Jember
Kalitengah	Lamongan
Kalitidu	Bojonegoro
Kaliwates	Jember
Kaliwedi	Cirebon
Kaliwiro	Wonosobo
Kaliwungu	Kendal
Kaliwungu	Kudus
Kaliwungu	Semarang
Kaliwungu Selatan	Kendal
Kalomdol	Pegunungan Bintang
Kalome	Puncak Jaya
Kalongan	Kepulauan Talaud
Kaloran	Temanggung
Kalukku	Mamuju
Kalumpang	Mamuju
Kalumpang (Kelumpang)	Hulu Sungai Selatan
Kamal	Bangkalan
Kamang Baru	Sijunjung
Kamang Magek	Agam
Kamanre	Luwu
Kambata Mapambuhang	Sumba Timur
Kambera	Sumba Timur
Kamboneri	Tolikara
Kambowa	Buton Utara
Kambrau (Kambraw / Kamberau)	Kaimana
Kambu	Kendari
Kamipang	Katingan
Kampa (Kampar Timur)	Kampar
Kampak	Trenggalek
Kampar	Kampar
Kampar Kiri	Kampar
Kampar Kiri Hilir	Kampar
Kampar Kiri Hulu	Kampar
Kampar Kiri Tengah	Kampar
Kampar Utara	Kampar
Kampung Laut	Cilacap
Kampung Melayu	Bengkulu
Kampung Rakyat	Labuhanbatu Selatan
Kamu	Dogiyai
Kamu Selatan	Dogiyai
Kamu Timur	Dogiyai
Kamu Utara (Ikrar/Ikrat)	Dogiyai
Kamundan	Teluk Bintuni
Kanatang	Sumba Timur
Kandangan	Temanggung
Kandangan	Kediri
Kandangan	Hulu Sungai Selatan
Kandanghaur	Indramayu
Kandangserang	Pekalongan
Kandat	Kediri
Kandeman	Batang
Kandis	Siak
Kandis	Ogan Ilir
Kangae	Sikka
Kangayan	Sumenep
Kanggime (Kanggima )	Tolikara
Kangkung	Kendal
Kanigaran	Probolinggo
Kanigoro	Blitar
Kanor	Bojonegoro
Kao	Halmahera Utara
Kao Barat	Halmahera Utara
Kao Teluk	Halmahera Utara
Kao Utara	Halmahera Utara
Kapalla Pitu (Kapala Pitu)	Toraja Utara
Kapas	Bojonegoro
Kapetakan	Cirebon
Kapiraya	Deiyai
Kapoiala	Konawe
Kapongan	Situbondo
Kapontori	Buton
Kaptel	Merauke
Kapuas (Sanggau Kapuas)	Sanggau
Kapuas Barat	Kapuas
Kapuas Hilir	Kapuas
Kapuas Hulu	Kapuas
Kapuas Kuala	Kapuas
Kapuas Murung	Kapuas
Kapuas Tengah	Kapuas
Kapuas Timur	Kapuas
Kapur IX/Sembilan	Lima Puluh Kota
Karamat	Buol
Karang Agung Ilir	Banyuasin
Karang Bahagia (Karangbahagia)	Bekasi
Karang Baru	Aceh Tamiang
Karang Bintang	Tanah Bumbu
Karang Dapo	Musi Rawas Utara
Karang Intan	Banjar
Karang Jaya	Musi Rawas Utara
Karang Jaya	Tasikmalaya
Karang Kancana (Karangkancana)	Kuningan
Karang Ploso (Karangploso)	Malang
Karang Tanjung	Pandeglang
Karang Tengah	Tangerang
Karang Tinggi	Bengkulu Tengah
Karangampel	Indramayu
Karangan	Trenggalek
Karangan	Kutai Timur
Karanganom	Klaten
Karanganyar	Demak
Karanganyar	Karanganyar
Karanganyar	Kebumen
Karanganyar	Pekalongan
Karanganyar	Purbalingga
Karanganyar	Ngawi
Karangasem (Karang Asem)	Karangasem
Karangawen	Demak
Karangbinangun	Lamongan
Karangdadap	Pekalongan
Karangdowo	Klaten
Karanggayam	Kebumen
Karanggede	Boyolali
Karanggeneng (Karang Geneng)	Lamongan
Karangjambu	Purbalingga
Karangjati	Ngawi
Karangkobar	Banjarnegara
Karanglewas	Banyumas
Karangmalang	Sragen
Karangmojo	Gunung Kidul
Karangmoncol	Purbalingga
Karangnongko	Klaten
Karangnunggal	Tasikmalaya
Karangpandan	Karanganyar
Karangpawitan	Garut
Karangpenang (Karang Penang)	Sampang
Karangpilang	Surabaya
Karangpucung	Cilacap
Karangrayung	Grobogan
Karangreja	Purbalingga
Karangrejo	Magetan
Karangrejo (Karang Rejo)	Tulungagung
Karangsambung	Kebumen
Karangsembung	Cirebon
Karangtengah	Cianjur
Karangtengah	Garut
Karangtengah	Wonogiri
Karangtengah (Karang Tengah)	Demak
Karangwareng	Cirebon
Karas	Magetan
Karas	Fakfak
Karau Kuala	Barito Selatan
Karawaci	Tangerang
Karawang Barat	Karawang
Karawang Timur	Karawang
Kare	Madiun
Karera	Sumba Timur
Karimun	Karimun
Karimun Jawa (Karimunjawa)	Jepara
Karossa	Mamuju Tengah
Kartasura	Sukoharjo
Kartoharjo	Madiun
Kartoharjo (Kertoharjo)	Magetan
Karu	Lanny Jaya
Karubaga	Tolikara
Karusen Janang	Barito Timur
Karya Penggawa	Pesisir Barat
Kasembon	Malang
Kasemen	Serang
Kasi	Tambrauw
Kasihan	Bantul
Kasiman	Bojonegoro
Kasimbar	Parigi Moutong
Kasiruta Barat	Halmahera Selatan
Kasiruta Timur	Halmahera Selatan
Kasokandel	Majalengka
Kasomalang	Subang
Kasreman	Ngawi
Kasui	Way Kanan
Katala Hamu Lingu	Sumba Timur
Katang Bidare	Lingga
Katapang	Bandung
Kateman	Indragiri Hilir
Katibung	Lampung Selatan
Katiku Tana	Sumba Tengah
Katiku Tana Selatan (Katikutana Selatan)	Sumba Tengah
Katingan Hilir	Katingan
Katingan Hulu	Katingan
Katingan Kuala	Katingan
Katingan Tengah	Katingan
Katobu	Muna
Katoi	Kolaka Utara
Kaubun	Kutai Timur
Kauditan	Minahasa Utara
Kauman	Ponorogo
Kauman	Tulungagung
Kaur Selatan	Kaur
Kaur Tengah	Kaur
Kaur Utara	Kaur
Kaureh	Jayapura
Kawagit	Boven Digoel
Kawali	Ciamis
Kawalu	Tasikmalaya
Kawangkoan	Minahasa
Kawangkoan Barat	Minahasa
Kawangkoan Utara	Minahasa
Kaway XVI	Aceh Barat
Kawedanan	Magetan
Kawor	Pegunungan Bintang
Kawunganten	Cilacap
Kayan Hilir	Sintang
Kayan Hilir	Malinau
Kayan Hulu	Sintang
Kayan Hulu	Malinau
Kayan Selatan	Malinau
Kayangan	Lombok Utara
Kayauni	Fakfak
Kayen	Pati
Kayen Kidul	Kediri
Kayo	Yahukimo
Kayoa	Halmahera Selatan
Kayoa Barat	Halmahera Selatan
Kayoa Selatan	Halmahera Selatan
Kayoa Utara	Halmahera Selatan
Kayu Agung	Ogan Komering Ilir
Kayu Aro	Kerinci
Kayu Aro Barat	Kerinci
Kebakkramat	Karanganyar
Kebar	Tambrauw
Kebar Selatan	Tambrauw
Kebar Timur	Tambrauw
Kebasen	Banyumas
Kebawetan	Kepahiang
Kebayakan	Aceh Tengah
Kebayoran Baru	Jakarta Selatan
Kebayoran Lama	Jakarta Selatan
Kebo	Paniai
Kebomas	Gresik
Kebon Jeruk	Jakarta Barat
Kebon Sari (Kebonsari)	Madiun
Kebonagung	Demak
Kebonagung (Kebon Agung)	Pacitan
Kebonarum	Klaten
Kebonpedes	Sukabumi
Kebumen	Kebumen
Kebun Tebu	Lampung Barat
Kedamaian	Bandar Lampung
Kedamean	Gresik
Kedaton	Bandar Lampung
Kedaton Peninjauan Raya	Ogan Komering Ulu
Kedawung	Cirebon
Kedawung	Sragen
Kedewan	Bojonegoro
Kediri	Tabanan
Kediri	Lombok Barat
Kedokan Bunder	Indramayu
Kedondong	Pesawaran
Kedopok (Kedopak)	Probolinggo
Kedu	Temanggung
Kedung	Jepara
Kedung Waringin	Bekasi
Kedungadem	Bojonegoro
Kedungbanteng (Kedung Banteng)	Banyumas
Kedungbanteng (Kedung Banteng)	Tegal
Kedungdung	Sampang
Kedunggalar	Ngawi
Kedungjajang	Lumajang
Kedungjati	Grobogan
Kedungkandang	Malang
Kedungpring	Lamongan
Kedungreja	Cilacap
Kedungtuban	Blora
Kedungwaru	Tulungagung
Kedungwuni	Pekalongan
Kedurang	Bengkulu Selatan
Kedurang Ilir	Bengkulu Selatan
Keera	Wajo
Kegayem	Nduga
Kei Besar	Maluku Tenggara
Kei Besar Selatan	Maluku Tenggara
Kei Besar Selatan Barat	Maluku Tenggara
Kei Besar Utara Barat	Maluku Tenggara
Kei Besar Utara Timur	Maluku Tenggara
Kei Kecil	Maluku Tenggara
Kei Kecil Barat	Maluku Tenggara
Kei Kecil Timur	Maluku Tenggara
Kei Kecil Timur Selatan	Maluku Tenggara
Kejajar	Wonosobo
Kejaksan	Cirebon
Kejayan	Pasuruan
Kejobong	Purbalingga
Kejuruan Muda	Aceh Tamiang
Kelam Permai	Sintang
Kelam Tengah	Kaur
Kelapa	Bangka Barat
Kelapa Dua	Tangerang
Kelapa Gading	Jakarta Utara
Kelapa Kampit	Belitung Timur
Kelapa Lima	Kupang
Kelara	Jeneponto
Kelay	Berau
Kelayang	Indragiri Hulu
Kelekar	Muara Enim
Kelila	Mamberamo Tengah
Keliling Danau	Kerinci
Kelimutu	Ende
Keling	Jepara
Kelua (Klua)	Tabalong
Keluang	Musi Banyuasin
Kelubagolit	Flores Timur
Kelulome	Lanny Jaya
Kelumpang Barat	Kotabaru
Kelumpang Hilir	Kotabaru
Kelumpang Hulu	Kotabaru
Kelumpang Selatan	Kotabaru
Kelumpang Tengah	Kotabaru
Kelumpang Utara	Kotabaru
Kema	Minahasa Utara
Kemalang	Klaten
Kemang	Bogor
Kemangkon	Purbalingga
Kemayoran	Jakarta Pusat
Kembang	Jepara
Kembang Janggut	Kutai Kartanegara
Kembang Tanjong	Pidie
Kembangan	Jakarta Barat
Kembangbahu	Lamongan
Kembaran	Banyumas
Kembayan	Sanggau
Kembru	Puncak
Kembu	Tolikara
Kemiling	Bandar Lampung
Kemiri	Tangerang
Kemiri	Purworejo
Kemlagi	Mojokerto
Kempas	Indragiri Hilir
Kempo	Dompu
Kemranjen	Banyumas
Kemtuk	Jayapura
Kemtuk Gresi	Jayapura
Kemuning	Indragiri Hilir
Kemuning	Palembang
Kemusu	Boyolali
Kencong	Jember
Kendahe	Kepulauan Sangihe
Kendal	Kendal
Kendal	Ngawi
Kendari	Kendari
Kendari Barat	Kendari
Kendawangan	Ketapang
Kendit	Situbondo
Kenduruan	Tuban
Kenjeran	Surabaya
Kenohan	Kutai Kartanegara
Kenyam	Nduga
Keo Tengah	Nagekeo
Kep. Bala Balakang	Mamuju
Kepahiang	Kepahiang
Kepala Madan	Buru Selatan
Kepanjen	Malang
Kepanjenkidul (Kepanjen Kidul)	Blitar
Kepenuhan	Rokan Hulu
Kepenuhan Hulu	Rokan Hulu
Kepil	Wonosobo
Kepohbaru	Bojonegoro
Kepulauan Ambai	Kepulauan Yapen
Kepulauan Aruri	Supiori
Kepulauan Ayau	Raja Ampat
Kepulauan Botanglomang	Halmahera Selatan
Kepulauan Joronga	Halmahera Selatan
Kepulauan Karimata	Kayong Utara
Kepulauan Manipa	Seram Bagian Barat
Kepulauan Marore	Kepulauan Sangihe
Kepulauan Masaloka Raya	Bombana
Kepulauan Pongok	Bangka Selatan
Kepulauan Posek	Lingga
Kepulauan Romang	Maluku Barat Daya
Kepulauan Sangkarrang	Makassar
Kepulauan Sembilan	Raja Ampat
Kepulauan Seribu Selatan	Kepulauan Seribu
Kepulauan Seribu Utara	Kepulauan Seribu
Kepulauan Tanakeke	Takalar
Kepung	Kediri
Kerajaan	Pakpak Bharat
Kerambitan	Tabanan
Kerek	Tuban
Kerinci Kanan	Siak
Keritang	Indragiri Hilir
Kerjo	Karanganyar
Kerkap	Bengkulu Utara
Kersamanah	Garut
Kersana	Brebes
Kertajati	Majalengka
Kertak Hanyar	Banjar
Kertanegara	Purbalingga
Kertapati	Palembang
Kertasari	Bandung
Kertasemaya	Indramayu
Kertek	Wonosobo
Kertosono	Nganjuk
Keruak	Lombok Timur
Kerumutan	Pelalawan
Kesamben	Blitar
Kesamben	Jombang
Kesambi	Cirebon
Kesesi	Pekalongan
Kesu	Toraja Utara
Kesugihan	Cilacap
Ketahun	Bengkulu Utara
Ketambe	Aceh Tenggara
Ketanggungan	Brebes
Ketapang	Sampang
Ketapang	Lampung Selatan
Ketol	Aceh Tengah
Ketungau Hilir	Sintang
Ketungau Hulu	Sintang
Ketungau Tengah	Sintang
Keumala	Pidie
Kewapante	Sikka
Ki	Boven Digoel
Kian Darat	Seram Bagian Timur
Kiaracondong	Bandung
Kiarapedes	Purwakarta
Kibin	Serang
Kie (Ki'e)	Timor Tengah Selatan
Kikim Barat	Lahat
Kikim Selatan	Lahat
Kikim Tengah	Lahat
Kikim Timur	Lahat
Kilmid	Nduga
Kilmury	Seram Bagian Timur
Kilo	Dompu
Kimaam	Merauke
Kinal	Kaur
Kinali	Pasaman Barat
Kindang	Bulukumba
Kinovaro	Sigi
Kintamani	Bangli
Kintap	Tanah Laut
Kintom	Banggai
Kirihi	Waropen
Kisam Ilir	Ogan Komering Ulu Selatan
Kisam Tinggi	Ogan Komering Ulu Selatan
Kisar Utara	Maluku Barat Daya
Kismantoro	Wonogiri
Kiwirok	Pegunungan Bintang
Kiwirok Timur	Pegunungan Bintang
Kiyage	Puncak Jaya
Klabang	Bondowoso
Klabot	Sorong
Klakah	Lumajang
Klambu	Grobogan
Klamono	Sorong
Klampis	Bangkalan
Klangenan	Cirebon
Klapanunggal	Bogor
Klari	Karawang
Klasafet	Sorong
Klaso	Sorong
Klaten Selatan	Klaten
Klaten Tengah	Klaten
Klaten Utara	Klaten
Klaurung	Sorong
Klawak	Sorong
Klayili	Sorong
Kledung	Temanggung
Klego	Boyolali
Klirong	Kebumen
Klojen	Malang
Kluet Selatan	Aceh Selatan
Kluet Tengah	Aceh Selatan
Kluet Timur	Aceh Selatan
Kluet Utara	Aceh Selatan
Klumbayan (Kelumbayan)	Tanggamus
Klumbayan Barat (Kelumbayan Barat)	Tanggamus
Klungkung	Klungkung
Koba	Bangka Tengah
Kobagma (Kobakma)	Mamberamo Tengah
Kobalima	Malaka
Kobalima Timur	Malaka
Kodeoha	Kolaka Utara
Kodi	Sumba Barat Daya
Kodi Balaghar	Sumba Barat Daya
Kodi Bangedo	Sumba Barat Daya
Kodi Utara	Sumba Barat Daya
Kofiau	Raja Ampat
Koja	Jakarta Utara
Kok Baun	Timor Tengah Selatan
Kokalukuna	Bau-Bau
Kokap	Kulon Progo
Kokas	Fakfak
Kokoda	Sorong Selatan
Kokoda Utara	Sorong Selatan
Kokop	Bangkalan
Kolaka	Kolaka
Kolang	Tapanuli Tengah
Kolawa	Lanny Jaya
Kolbano	Timor Tengah Selatan
Kolf Braza	Asmat
Kolono	Konawe Selatan
Kolono Timur	Konawe Selatan
Kombay	Boven Digoel
Kombeng (Kongbeng)	Kutai Timur
Kombi	Minahasa
Kombut	Boven Digoel
Komodo	Manggarai Barat
Kona	Yahukimo
Konang	Bangkalan
Konawe	Konawe
Konda	Konawe Selatan
Konda	Sorong Selatan
Kondaga (Konda)	Tolikara
Konhir	Sorong
Kontu Kowuna	Muna
Kontunaga	Muna
Kopang	Lombok Tengah
Kopay	Asmat
Kopo	Serang
Kora	Nduga
Koragi	Jayawijaya
Kormomolin	Kepulauan Tanimbar (Maluku Tenggara Barat)
Koroncong	Pandeglang
Koroptak	Nduga
Koropun (Korupun)	Yahukimo
Kosambi	Tangerang
Kosarek	Yahukimo
Kosiwo	Kepulauan Yapen
Kot Olin	Timor Tengah Selatan
Kota (Kediri Kota)	Kediri
Kota Agung	Lahat
Kota Agung (Kota Agung Pusat)	Tanggamus
Kota Agung Barat	Tanggamus
Kota Agung Timur	Tanggamus
Kota Arga Makmur	Bengkulu Utara
Kota Atambua (Atambua Kota)	Belu
Kota Bahagia	Aceh Selatan
Kota Baharu	Aceh Singkil
Kota Bangun	Kutai Kartanegara
Kota Barat	Gorontalo
Kota Baru	Jambi
Kota Baru	Ende
Kota Baru (Kotabaru)	Karawang
Kota Besi	Kotawaringin Timur
Kota Cot Glie (Kuta Cot Glie)	Aceh Besar
Kota Gajah	Lampung Tengah
Kota Jantho	Aceh Besar
Kota Juang	Bireuen
Kota Kefamenanu	Timor Tengah Utara
Kota Kisaran Barat	Asahan
Kota Kisaran Timur	Asahan
Kota Komba	Manggarai Timur
Kota Kualasinpang (Kota Kuala Simpang)	Aceh Tamiang
Kota Kudus (Kudus Kota)	Kudus
Kota Lama	Kupang
Kota Maba	Halmahera Timur
Kota Malaka (Kuta Malaka)	Aceh Besar
Kota Manna	Bengkulu Selatan
Kota Masohi	Maluku Tengah
Kota Mukomuko (Mukomuko Utara)	Muko Muko
Kota Padang	Rejang Lebong
Kota Raja	Kupang
Kota Selatan	Gorontalo
Kota Sigli	Pidie
Kota Soe	Timor Tengah Selatan
Kota Sumenep	Sumenep
Kota Tambolaka	Sumba Barat Daya
Kota Tengah	Gorontalo
Kota Ternate Selatan	Ternate
Kota Ternate Tengah	Ternate
Kota Ternate Utara	Ternate
Kota Timur	Gorontalo
Kota Utara	Gorontalo
Kota Waikabubak	Sumba Barat
Kota Waingapu	Sumba Timur
Kota Waisai	Raja Ampat
Kotaanyar (Kota Anyar)	Probolinggo
Kotabumi	Lampung Utara
Kotabumi Selatan	Lampung Utara
Kotabumi Utara	Lampung Utara
Kotabunan	Bolaang Mongondow Timur
Kotagede	Yogyakarta
Kotamobagu Barat	Kotamobagu
Kotamobagu Selatan	Kotamobagu
Kotamobagu Timur	Kotamobagu
Kotamobagu Utara	Kotamobagu
Kotanopan	Mandailing Natal
Kotapinang (Kota Pinang)	Labuhanbatu Selatan
Kotarih	Serdang Bedagai
Kotawaringin Lama	Kotawaringin Barat
Koting	Sikka
Koto Balingka	Pasaman Barat
Koto Baru	Dharmasraya
Koto Baru	Sungaipenuh
Koto Besar	Dharmasraya
Koto Gasib	Siak
Koto Kampar Hulu	Kampar
Koto Parik Gadang Diateh	Solok Selatan
Koto Salak	Dharmasraya
Koto Tangah	Padang
Koto VII	Sijunjung
Koto XI Tarusan	Pesisir Selatan
Kouh	Boven Digoel
Kradenan	Blora
Kradenan	Grobogan
Kragan	Rembang
Kragilan	Serang
Kraksaan	Probolinggo
Kramat	Tegal
Kramatjati (Kramat Jati)	Jakarta Timur
Kramatmulya (Kramat Mulya)	Kuningan
Kramatwatu	Serang
Kramongmongga	Fakfak
Kranggan	Temanggung
Kranggan	Mojokerto
Krangkeng	Indramayu
Kras	Kediri
Kraton	Yogyakarta
Kraton	Pasuruan
Krayan	Nunukan
Krayan Barat	Nunukan
Krayan Selatan	Nunukan
Krayan Tengah	Nunukan
Krayan Timur	Nunukan
Krejengan	Probolinggo
Krembangan	Surabaya
Krembung	Sidoarjo
Krepkuri	Nduga
Kresek	Tangerang
Kretek	Bantul
Krian	Sidoarjo
Kromengan	Malang
Kronjo	Tangerang
Kroya	Indramayu
Kroya	Cilacap
Krucil	Probolinggo
Krueng Barona Jaya	Aceh Besar
Krueng Sabee	Aceh Jaya
Krui Selatan	Pesisir Barat
Kuala	Langkat
Kuala	Bireuen
Kuala	Nagan Raya
Kuala Baru	Aceh Singkil
Kuala Batee	Aceh Barat Daya
Kuala Behe	Landak
Kuala Betara	Tanjung Jabung Barat
Kuala Cenaku	Indragiri Hulu
Kuala Indragiri	Indragiri Hilir
Kuala Jambi	Tanjung Jabung Timur
Kuala Kampar	Pelalawan
Kuala Kencana	Mimika
Kuala Mandor B	Kubu Raya
Kuala Pesisir	Nagan Raya
Kualin	Timor Tengah Selatan
Kualuh Hilir	Labuhanbatu Utara
Kualuh Hulu	Labuhanbatu Utara
Kualuh Leidong	Labuhanbatu Utara
Kualuh Selatan	Labuhanbatu Utara
Kuanfatu	Timor Tengah Selatan
Kuantan Hilir	Kuantan Singingi
Kuantan Hilir Seberang	Kuantan Singingi
Kuantan Mudik	Kuantan Singingi
Kuantan Tengah	Kuantan Singingi
Kuari	Tolikara
Kuaro	Paser
Kuatnana	Timor Tengah Selatan
Kubu	Tolikara
Kubu	Rokan Hilir
Kubu	Karangasem
Kubu	Kubu Raya
Kubu Babussalam	Rokan Hilir
Kubung	Solok
Kubutambahan	Buleleng
Kudu	Jombang
Kulawi	Sigi
Kulawi Selatan	Sigi
Kulisusu (Kalingsusu/Kalisusu)	Buton Utara
Kulisusu Barat	Buton Utara
Kulisusu Utara	Buton Utara
Kulo	Sidenreng Rappang
Kuly Lanny	Lanny Jaya
Kumai	Kotawaringin Barat
Kumelembuai	Minahasa Selatan
Kumpeh	Muaro Jambi
Kumpeh Ulu	Muaro Jambi
Kumun Debai	Sungaipenuh
Kundur	Karimun
Kundur Barat	Karimun
Kundur Utara	Karimun
Kunduran	Blora
Kuningan	Kuningan
Kunir	Lumajang
Kunjang	Kediri
Kunto Darussalam	Rokan Hulu
Kuok	Kampar
Kupang Barat	Kupang
Kupang Tengah	Kupang
Kupang Timur	Kupang
Kupitan	Sijunjung
Kur Selatan	Tual
Kuranji	Tanah Bumbu
Kuranji	Padang
Kurau	Tanah Laut
Kuri	Teluk Bintuni
Kuri Wamesa	Teluk Wondama
Kurik	Merauke
Kurima	Yahukimo
Kuripan	Probolinggo
Kuripan	Barito Kuala
Kuripan	Lombok Barat
Kurra	Tana Toraja
Kurulu	Jayawijaya
Kurun	Gunung Mas
Kusambi	Muna Barat
Kusan Hilir	Tanah Bumbu
Kusan Hulu	Tanah Bumbu
Kuta	Badung
Kuta Alam	Banda Aceh
Kuta Baro	Aceh Besar
Kuta Blang	Bireuen
Kuta Makmur	Aceh Utara
Kuta Raja	Banda Aceh
Kuta Selatan	Badung
Kuta Utara	Badung
Kutabuluh (Kuta Buluh)	Karo
Kutalimbaru	Deli Serdang
Kutambaru	Langkat
Kutapanjang (Kuta Panjang)	Gayo Lues
Kutasari	Purbalingga
Kutawaluya	Karawang
Kutawaringin	Bandung
Kute Panang	Aceh Tengah
Kutoarjo	Purworejo
Kutorejo	Mojokerto
Kutowinangun	Kebumen
Kuwarasan	Kebumen
Kuwus	Manggarai Barat
Kuwus Barat	Manggarai Barat
Kuyawage	Lanny Jaya
Kwadungan	Ngawi
Kwamki Narama	Mimika
Kwandang	Gorontalo Utara
Kwanyar	Bangkalan
Kwelemdua (Kwelamdua)	Yahukimo
Kwesefo	Tambrauw
Kwikma	Yahukimo
Kwoor	Tambrauw
Labakkang	Pangkajene Kepulauan
Labang	Bangkalan
Labangka	Sumbawa
Labobo	Banggai Laut
Laboya Barat (Lamboya Barat)	Sumba Barat
Labuan	Donggala
Labuan	Pandeglang
Labuan Amas Selatan	Hulu Sungai Tengah
Labuan Amas Utara	Hulu Sungai Tengah
Labuapi	Lombok Barat
Labuhan Badas	Sumbawa
Labuhan Deli	Deli Serdang
Labuhan Haji	Aceh Selatan
Labuhan Haji	Lombok Timur
Labuhan Haji Barat	Aceh Selatan
Labuhan Haji Timur	Aceh Selatan
Labuhan Maringgai	Lampung Timur
Labuhan Ratu	Lampung Timur
Labuhan Ratu	Bandar Lampung
Ladongi	Kolaka Timur
Lae Parira	Dairi
Laenmanen	Malaka
Laeya	Konawe Selatan
Lage	Poso
Laguboti	Toba Samosir
Laham	Mahakam Ulu
Lahat	Lahat
Lahat Selatan	Lahat
Lahei	Barito Utara
Lahei Barat	Barito Utara
Lahewa	Nias Utara
Lahewa Timur	Nias Utara
Lahomi (Gahori)	Nias Barat
Lahusa	Nias Selatan
Lainea	Konawe Selatan
Lais	Musi Banyuasin
Lais	Bengkulu Utara
Lakarsantri	Surabaya
Lakbok	Ciamis
Lakea (Lipunoto)	Buol
Lakudo	Buton Tengah
Lalabata	Soppeng
Lalan	Musi Banyuasin
Lalembuu	Konawe Selatan
Lalolae	Kolaka Timur
Lalonggasumeeto	Konawe
Lamaknen	Belu
Lamaknen Selatan	Belu
Lamala	Banggai
Lamandau	Lamandau
Lamasi	Luwu
Lamasi Timur	Luwu
Lamba Leda	Manggarai Timur
Lambai	Kolaka Utara
Lambandia	Kolaka Timur
Lambewi	Puncak
Lambitu	Bima
Lamboya	Sumba Barat
Lambu	Bima
Lambu Kibang	Tulang Bawang Barat
Lambuya	Konawe
Lamongan	Lamongan
Lampasio	Toli-Toli
Lampihong	Balangan
Lamposi Tigo Nagori / Nagari	Payakumbuh
Lamuru	Bone
Landasan Ulin	Banjarbaru
Landawe	Konawe Utara
Landono	Konawe Selatan
Landu Leko	Rote Ndao
Langda	Yahukimo
Langensari	Banjar
Langgam	Pelalawan
Langgikima	Konawe Utara
Langgudu	Bima
Langkahan	Aceh Utara
Langkaplancar	Pangandaran
Langkapura	Bandar Lampung
Langke Rembong	Manggarai
Langowan Barat	Minahasa
Langowan Selatan	Minahasa
Langowan Timur	Minahasa
Langowan Utara	Minahasa
Langsa Barat	Langsa
Langsa Baro	Langsa
Langsa Kota	Langsa
Langsa Lama	Langsa
Langsa Timur	Langsa
Lannyna	Lanny Jaya
Lansirang (Lanrisang)	Pinrang
Lantari Jaya	Bombana
Lantung	Sumbawa
Laonti	Konawe Selatan
Lapandewa	Buton Selatan
Lapang	Aceh Utara
Lape (Lape Lopok)	Sumbawa
Lappariaja	Bone
Larangan	Tangerang
Larangan	Brebes
Larangan	Pamekasan
Larantuka	Flores Timur
Lareh Sago Halaban	Lima Puluh Kota
Laren	Lamongan
Lariang	Pasangkayu (Mamuju Utara)
Larompong	Luwu
Larompong Selatan	Luwu
Lasalepa	Muna
Lasalimu	Buton
Lasalimu Selatan	Buton
Lasem	Rembang
Lasiolat	Belu
Lasolo	Konawe Utara
Lasolo Kepulauan	Konawe Utara
Lasusua	Kolaka Utara
Latambaga	Kolaka
Latimojong	Luwu
Latoma	Konawe
Lau	Maros
Laubaleng	Karo
Laung Tuhup	Murung Raya
Laut Tador	Batu Bara
Laut Tawar (Lut Tawar)	Aceh Tengah
Lawa	Muna Barat
Lawang	Malang
Lawang Kidul	Muara Enim
Lawang Wetan	Musi Banyuasin
Lawe Alas	Aceh Tenggara
Lawe Bulan	Aceh Tenggara
Lawe Sigala Gala	Aceh Tenggara
Lawe Sumur	Aceh Tenggara
Laweyan	Surakarta
Lea-Lea	Bau-Bau
Lebak Wangi	Serang
Lebakbarang	Pekalongan
Lebakgedong	Lebak
Lebaksiu	Tegal
Lebakwangi	Kuningan
Lebatukan	Lembata
Lebong Atas	Lebong
Lebong Sakti	Lebong
Lebong Selatan	Lebong
Lebong Tengah	Lebong
Lebong Utara	Lebong
Leces	Probolinggo
Lede	Pulau Taliabu
Ledo	Bengkayang
Ledokombo	Jember
Legok	Tangerang
Legonkulon	Subang
Leihitu	Maluku Tengah
Leihitu Barat	Maluku Tengah
Leitimur Selatan	Ambon
Lekok	Pasuruan
Leksono	Wonosobo
Leksula	Buru Selatan
Lela	Sikka
Lelak	Manggarai
Lelea	Indramayu
Leles	Cianjur
Leles	Garut
Lemah Wungkuk (Lemahwungkuk)	Cirebon
Lemahabang	Cirebon
Lemahabang	Karawang
Lemahsugih	Majalengka
Lembah Bawang	Bengkayang
Lembah Gumanti	Solok
Lembah Masurai	Merangin
Lembah Melintang	Pasaman Barat
Lembah Sabil	Aceh Barat Daya
Lembah Segar	Sawah Lunto
Lembah Seulawah	Aceh Besar
Lembah Sorik Marapi	Mandailing Natal
Lembak	Muara Enim
Lembang	Pinrang
Lembang	Bandung Barat
Lembang Jaya	Solok
Lembar	Lombok Barat
Lembean Timur	Minahasa
Lembeh Selatan (Bitung Selatan)	Bitung
Lembeh Utara	Bitung
Lembeyan	Magetan
Lembo	Morowali Utara
Lembo	Konawe Utara
Lembo Raya	Morowali Utara
Lembor	Manggarai Barat
Lembor Selatan	Manggarai Barat
Lembur	Alor
Lembursitu	Sukabumi
Lemito	Pohuwato
Lemong	Pesisir Barat
Lempuing	Ogan Komering Ilir
Lempuing Jaya	Ogan Komering Ilir
Lenangguar	Sumbawa
Lendah	Kulon Progo
Lenek	Lombok Timur
Lengayang	Pesisir Selatan
Lengkiti	Ogan Komering Ulu
Lengkong	Nganjuk
Lengkong	Bandung
Lengkong	Sukabumi
Lenteng	Sumenep
Lepar Pongok	Bangka Selatan
Lepembusu Kelisoke	Ende
Leupung	Aceh Besar
Leuser	Aceh Tenggara
Leuwidamar	Lebak
Leuwigoong	Garut
Leuwiliang	Bogor
Leuwimunding	Majalengka
Leuwisadeng	Bogor
Leuwisari	Tasikmalaya
Lewa	Sumba Timur
Lewa Tidahu	Sumba Timur
Lewolema	Flores Timur
Lhoknga (Lho'nga)	Aceh Besar
Lhoksukon	Aceh Utara
Lhoong	Aceh Besar
Li Anogomma	Tolikara
Liang	Banggai Kepulauan
Liang Anggang	Banjarbaru
Libarek	Jayawijaya
Libureng	Bone
Licin	Banyuwangi
Ligung	Majalengka
Likupang Barat	Minahasa Utara
Likupang Selatan	Minahasa Utara
Likupang Timur	Minahasa Utara
Lilialy	Buru
Liliraja (Lili Riaja)	Soppeng
Lilirilau (Lili Rilau)	Soppeng
Lima Kaum	Tanah Datar
Lima Puluh	Pekanbaru
Lima Puluh (Limapuluh)	Batu Bara
Lima Puluh Pesisir	Batu Bara
Limau	Tanggamus
Limbangan	Kendal
Limbong	Luwu Utara
Limboro	Polewali Mandar
Limboto	Gorontalo
Limboto Barat	Gorontalo
Limbur Lubuk Mengkuang	Bungo
Limo	Depok
Limpasu	Hulu Sungai Tengah
Limpung	Batang
Limun	Sarolangun
Lindu	Sigi
Linge	Aceh Tengah
Lingga	Lingga
Lingga Bayu	Mandailing Natal
Lingga Timur	Lingga
Lingga Utara	Lingga
Linggang Bigung	Kutai Barat
Linggo Sari Baganti	Pesisir Selatan
Lingsar	Lombok Barat
Lintang Kanan	Empat Lawang
Lintau Buo	Tanah Datar
Lintau Buo Utara	Tanah Datar
Lintong Nihuta	Humbang Hasundutan
Lio Timur	Ende
Lirik	Indragiri Hulu
Lirung	Kepulauan Talaud
Liukang Kalmas (Kalukuang Masalima)	Pangkajene Kepulauan
Liukang Tangaya	Pangkajene Kepulauan
Liukang Tupabbiring	Pangkajene Kepulauan
Liukang Tupabbiring Utara	Pangkajene Kepulauan
Loa Janan	Kutai Kartanegara
Loa Janan Ilir	Samarinda
Loa Kulu	Kutai Kartanegara
Loano	Purworejo
Lobalain	Rote Ndao
Lobu	Banggai
Loceret	Nganjuk
Loea	Kolaka Timur
Logas Tanah Darat	Kuantan Singingi
Lohbener	Indramayu
Lohia	Muna
Lokpaikat	Tapin
Loksado	Hulu Sungai Selatan
Lolak	Bolaang Mongondow
Lolat	Yahukimo
Lolayan	Bolaang Mongondow
Loli	Sumba Barat
Loloda	Halmahera Barat
Loloda Kepulauan	Halmahera Utara
Loloda Utara	Halmahera Utara
Lolofitu Moi	Nias Barat
Lolomatua	Nias Selatan
Lolong Guba	Buru
Lolowau	Nias Selatan
Long Apari	Mahakam Ulu
Long Bagun	Mahakam Ulu
Long Hubung	Mahakam Ulu
Long Ikis	Paser
Long Iram	Kutai Barat
Long Kali	Paser
Long Mesangat	Kutai Timur
Long Pahangai	Mahakam Ulu
Longkib	Subulussalam
Lopok	Sumbawa
Lore Barat	Poso
Lore Piore	Poso
Lore Selatan	Poso
Lore Tengah	Poso
Lore Timur	Poso
Lore Utara	Poso
Losarang	Indramayu
Losari	Cirebon
Losari	Brebes
Lotu	Nias Utara
Loura	Sumba Barat Daya
Lowokwaru	Malang
Luahagundre Maniamolo	Nias Selatan
Luak (Luhak)	Lima Puluh Kota
Luas	Kaur
Lubai	Muara Enim
Lubai Ulu	Muara Enim
Lubuak Tarok	Sijunjung
Lubuk Alung	Padang Pariaman
Lubuk Baja	Batam
Lubuk Barumun	Padang Lawas
Lubuk Basung	Agam
Lubuk Batang	Ogan Komering Ulu
Lubuk Batu Jaya	Indragiri Hulu
Lubuk Begalung	Padang
Lubuk Besar	Bangka Tengah
Lubuk Dalam	Siak
Lubuk Keliat	Ogan Ilir
Lubuk Kilangan	Padang
Lubuk Linggau Barat Dua (II)	Lubuk Linggau
Lubuk Linggau Barat Satu (I)	Lubuk Linggau
Lubuk Linggau Selatan Dua (II)	Lubuk Linggau
Lubuk Linggau Selatan Satu (I)	Lubuk Linggau
Lubuk Linggau Timur Dua (II)	Lubuk Linggau
Lubuk Linggau Timur Satu (I)	Lubuk Linggau
Lubuk Linggau Utara Dua (II)	Lubuk Linggau
Lubuk Linggau Utara Satu (I)	Lubuk Linggau
Lubuk Pakam	Deli Serdang
Lubuk Pinang	Muko Muko
Lubuk Raja	Ogan Komering Ulu
Lubuk Sandi	Seluma
Lubuk Sikaping	Pasaman
Lubuk Sikarah	Solok
Lueng Bata	Banda Aceh
Luhak Nan Duo	Pasaman Barat
Lumajang	Lumajang
Lumar	Bengkayang
Lumban Julu	Toba Samosir
Lumbang	Pasuruan
Lumbang	Probolinggo
Lumbir	Banyumas
Lumbis	Nunukan
Lumbis Ogong	Nunukan
Lumbok Seminung	Lampung Barat
Lumbung	Ciamis
Lumo	Puncak Jaya
Lumut	Tapanuli Tengah
Lunang	Pesisir Selatan
Lungkang Kule	Kaur
Lunyuk	Sumbawa
Luragung	Kuningan
Luwuk	Banggai
Luwuk Selatan	Banggai
Luwuk Timur	Banggai
Luwuk Utara	Banggai
Luyo	Polewali Mandar
Ma'u	Nias
Maba	Halmahera Timur
Maba Selatan	Halmahera Timur
Maba Tengah	Halmahera Timur
Maba Utara	Halmahera Timur
Mabugi	Puncak
Macang Pacar	Manggarai Barat
Madang Suku I	Ogan Komering Ulu Timur
Madang Suku II	Ogan Komering Ulu Timur
Madang Suku III	Ogan Komering Ulu Timur
Madapangga	Bima
Madat	Aceh Timur
Madidir (Bitung Tengah)	Bitung
Madiun	Madiun
Madukara	Banjarnegara
Maduran	Lamongan
Maesa	Bitung
Maesaan	Minahasa Selatan
Maesan	Bondowoso
Mage'abume	Puncak
Magelang Selatan	Magelang
Magelang Tengah	Magelang
Magelang Utara	Magelang
Magepanda	Sikka
Magersari	Mojokerto
Magetan	Magetan
Maginti	Muna Barat
Mahu	Sumba Timur
Mahuning Raya (Manuhing Raya)	Gunung Mas
Maima	Jayawijaya
Maiwa	Enrekang
Maja	Lebak
Maja	Majalengka
Majalaya	Bandung
Majalaya	Karawang
Majalengka	Majalengka
Majasari	Pandeglang
Majauleng	Wajo
Maje	Kaur
Majenang	Cilacap
Makale	Tana Toraja
Makale Selatan	Tana Toraja
Makale Utara	Tana Toraja
Makarti Jaya	Banyuasin
Makasar	Jakarta Timur
Makassar	Makassar
Makbon	Sorong
Makian Barat	Halmahera Selatan
Makimi	Nabire
Makki	Lanny Jaya
Makmur	Bireuen
Malabotom	Sorong
Maladum Mes	Sorong
Malaimsimsa	Sorong
Malaka Barat	Malaka
Malaka Tengah	Malaka
Malaka Timur	Malaka
Malalak (Malakak)	Agam
Malalayang	Manado
Malangbong	Garut
Malangke	Luwu Utara
Malangke Barat	Luwu Utara
Malausma	Majalengka
Maleber	Kuningan
Malifut	Halmahera Utara
Maligano	Muna
Maliku	Pulang Pisau
Malili	Luwu Timur
Malimbong Balepe	Tana Toraja
Malin Deman	Muko Muko
Malinau Barat	Malinau
Malinau Kota	Malinau
Malinau Selatan	Malinau
Malinau Selatan Hilir	Malinau
Malinau Selatan Hulu	Malinau
Malinau Utara	Malinau
Malind	Merauke
Malingping	Lebak
Malllawa (Mallawa)	Maros
Mallusetasi	Barru
Malo	Bojonegoro
Malua	Enrekang
Maluk	Sumbawa Barat
Malunda	Majene
Mam	Nduga
Mamajang	Makassar
Mamasa	Mamasa
Mamberamo Hilir	Mamberamo Raya
Mamberamo Hulu	Mamberamo Raya
Mamberamo Tengah	Mamberamo Raya
Mamberamo Tengah Timur	Mamberamo Raya
Mambi	Mamasa
Mambioman Bapai	Mappi
Mamboro	Sumba Tengah
Mamosalato	Morowali Utara
Mampang Prapatan	Jakarta Selatan
Mamuju	Mamuju
Mananggu	Boalemo
Mancak	Serang
Mandah	Indragiri Hilir
Mandai	Maros
Mandalajati	Bandung
Mandalawangi	Pandeglang
Mandalle	Pangkajene Kepulauan
Mandastana	Barito Kuala
Mandau	Bengkalis
Mandau Talawang	Kapuas
Mande	Cianjur
Mandiangin	Sarolangun
Mandiangin Koto Selayan	Bukittinggi
Manding	Sumenep
Mandioli Selatan	Halmahera Selatan
Mandioli Utara	Halmahera Selatan
Mandiraja	Banjarnegara
Mandirancan	Kuningan
Mandobo	Boven Digoel
Mandolang	Minahasa
Mandonga	Kendari
Mandor	Landak
Mandrehe	Nias Barat
Mandrehe Barat	Nias Barat
Mandrehe Utara	Nias Barat
Manduamas	Tapanuli Tengah
Mane	Pidie
Manekar	Tambrauw
Manganitu	Kepulauan Sangihe
Manganitu Selatan	Kepulauan Sangihe
Mangarabombang (Mangara Bombang)	Takalar
Mangaran	Situbondo
Manggala	Makassar
Manggalewa	Dompu
Manggar	Belitung Timur
Manggelum	Boven Digoel
Manggeng	Aceh Barat Daya
Manggis	Karangasem
Mangkubumi	Tasikmalaya
Mangkutana	Luwu Timur
Mangoli Barat	Kepulauan Sula
Mangoli Selatan	Kepulauan Sula
Mangoli Tengah	Kepulauan Sula
Mangoli Timur	Kepulauan Sula
Mangoli Utara	Kepulauan Sula
Mangoli Utara Timur	Kepulauan Sula
Manguharjo	Madiun
Mangunjaya	Pangandaran
Mangunreja	Tasikmalaya
Maniamolo	Nias Selatan
Maniangpajo	Wajo
Maniis	Purwakarta
Manimeri	Teluk Bintuni
Manis Mata	Ketapang
Manisrenggo	Klaten
Manna	Bengkulu Selatan
Mannem	Keerom
Manokwari Barat	Manokwari
Manokwari Selatan	Manokwari
Manokwari Timur	Manokwari
Manokwari Utara	Manokwari
Manonjaya	Tasikmalaya
Mantang	Bintan
Mantangai	Kapuas
Mantasiek (Montasik)	Aceh Besar
Mantewe	Tanah Bumbu
Mantikulore	Palu
Mantingan	Ngawi
Mantoh	Banggai
Mantrijeron	Yogyakarta
Mantup	Lamongan
Manuhing	Gunung Mas
Manuju	Gowa
Manyak Payed	Aceh Tamiang
Manyar	Gresik
Manyaran	Wonogiri
Manyeuw	Maluku Tenggara
Maos	Cilacap
Maospati	Magetan
Mapanget	Manado
Mapat Tunggul	Pasaman
Mapat Tunggul Selatan	Pasaman
Mapenduma	Nduga
Mapia	Dogiyai
Mapia Barat	Dogiyai
Mapia Tengah	Dogiyai
Mapilli	Polewali Mandar
Mapitara	Sikka
Mappak	Tana Toraja
Mappakasunggu	Takalar
Mappedeceng	Luwu Utara
Marabahan	Barito Kuala
Marancar	Tapanuli Selatan
Marang (Ma Rang)	Pangkajene Kepulauan
Marang Kayu	Kutai Kartanegara
Maratua	Berau
Marau	Ketapang
Marawola	Sigi
Marawola Barat	Sigi
Marbau	Labuhanbatu Utara
Mardingding (Mardinding)	Karo
Mare	Maybrat
Mare	Bone
Mare Selatan	Maybrat
Marga	Tabanan
Marga Punduh	Pesawaran
Marga Sakti Sebelat (Marga Sakti)	Bengkulu Utara
Marga Sekampung	Lampung Timur
Marga Tiga (Margatiga)	Lampung Timur
Margaasih	Bandung
Margadana	Tegal
Margahayu	Bandung
Margasari	Tegal
Margo Tabir	Merangin
Margomulyo	Bojonegoro
Margorejo	Pati
Margoyoso	Pati
Mariat	Sorong
Marikit	Katingan
Marioriawa (Mario Riawa)	Soppeng
Marioriwawo (Mario Riwawo)	Soppeng
Marisa	Pohuwato
Mariso	Makassar
Maritengngae	Sidenreng Rappang
Maro Sebo	Muaro Jambi
Maro Sebo Ilir	Batang Hari
Maro Sebo Ulu	Batang Hari
Marobo	Muna
Maron	Probolinggo
Maronge	Sumbawa
Maros Baru	Maros
Marpoyan Damai	Pekanbaru
Martapura	Ogan Komering Ulu Timur
Martapura (Martapura Kota)	Banjar
Martapura Barat	Banjar
Martapura Timur	Banjar
Marusu	Maros
Masalembu	Sumenep
Masalle	Enrekang
Masama	Banggai
Masamba	Luwu Utara
Masanda	Tana Toraja
Masaran	Sragen
Masbagik	Lombok Timur
Masirei	Waropen
Masni	Manokwari
Masyeta	Teluk Bintuni
Mata Oleo	Bombana
Mata Usu	Bombana
Matakali	Polewali Mandar
Matan Hilir Selatan	Ketapang
Matan Hilir Utara	Ketapang
Matangkuli	Aceh Utara
Matangnga	Polewali Mandar
Mataram	Mataram
Mataram Baru	Lampung Timur
Mataraman	Banjar
Mataru	Alor
Matawai Lappau (La Pawu)	Sumba Timur
Matemani	Sorong Selatan
Matesih	Karanganyar
Matirro Sompe (Mattiro Sompe)	Pinrang
Matraman	Jakarta Timur
Mattiro Bulu	Pinrang
Matuari (Bitung Barat)	Bitung
Matur	Agam
Maudus	Sorong
Mauk	Tangerang
Maukaro	Ende
Maulafa	Kupang
Mauponggo	Nagekeo
Maurole	Ende
Mawabuan	Tambrauw
Mawasangka	Buton Tengah
Mawasangka Tengah	Buton Tengah
Mawasangka Timur	Buton Tengah
Mayamuk	Sorong
Mayang	Jember
Mayangan	Probolinggo
Mayong	Jepara
Mazino	Nias Selatan
Mazo	Nias Selatan
Mbahamdandara	Fakfak
Mbeliling	Manggarai Barat
Mbua Tengah	Nduga
Mbulmu Yalma	Nduga
Mbuwa (Mbua / Mbuga)	Nduga
Mebarok	Nduga
Medan Amplas	Medan
Medan Area	Medan
Medan Barat	Medan
Medan Baru	Medan
Medan Belawan (Medan Belawan Kota)	Medan
Medan Deli	Medan
Medan Denai	Medan
Medan Helvetia	Medan
Medan Johor	Medan
Medan Kota	Medan
Medan Labuhan	Medan
Medan Maimun	Medan
Medan Marelan	Medan
Medan Perjuangan	Medan
Medan Petisah	Medan
Medan Polonia	Medan
Medan Selayang	Medan
Medan Sunggal	Medan
Medan Tembung	Medan
Medan Timur	Medan
Medan Tuntungan	Medan
Medang Deras	Batu Bara
Medang Kampai	Dumai
Medansatria (Medan Satria)	Bekasi
Megaluh	Jombang
Megambilis	Mamberamo Tengah
Megamendung	Bogor
Megang Sakti	Musi Rawas
Mego	Sikka
Mehalaan	Mamasa
Mejayan	Madiun
Mejobo	Kudus
Mekakau Ilir	Ogan Komering Ulu Selatan
Mekar Baru	Tangerang
Mekarjaya	Pandeglang
Mekarmukti	Garut
Mekarsari (Mekar Sari)	Barito Kuala
Melagi	Lanny Jaya
Melagineri	Lanny Jaya
Melak	Kutai Barat
Melaya	Jembrana
Meliau	Sanggau
Melinting	Lampung Timur
Melonguane	Kepulauan Talaud
Melonguane Timur	Kepulauan Talaud
Meluhu	Konawe
Membalong	Belitung
Membey	Pegunungan Arfak
Mempawah Hilir	Mempawah
Mempawah Hulu	Landak
Mempawah Timur	Mempawah
Mempura	Siak
Mendahara	Tanjung Jabung Timur
Mendahara Ulu	Tanjung Jabung Timur
Mendawai	Katingan
Mendo Barat	Bangka
Mendoyo	Jembrana
Menes	Pandeglang
Menganti	Gresik
Menggala	Tulang Bawang
Menggala Timur	Tulang Bawang
Mengkendek	Tana Toraja
Mengwi	Badung
Menjalin	Landak
Menou	Nabire
Mentarang	Malinau
Mentarang Hulu	Malinau
Mentawa Baru Ketapang	Kotawaringin Timur
Mentaya Hilir Selatan	Kotawaringin Timur
Mentaya Hilir Utara	Kotawaringin Timur
Mentaya Hulu	Kotawaringin Timur
Mentebah	Kapuas Hulu
Menteng	Jakarta Pusat
Menthobi Raya	Lamandau
Mentok (Muntok)	Bangka Barat
Menui Kepulauan	Morowali
Menukung	Melawi
Menyuke	Landak
Meos Mansar	Raja Ampat
Mepanga	Parigi Moutong
Meraksa Aji	Tulang Bawang
Merakurak	Tuban
Meral	Karimun
Meral Barat	Karimun
Meranti	Landak
Meranti	Asahan
Merapi Barat	Lahat
Merapi Selatan	Lahat
Merapi Timur	Lahat
Merauke	Merauke
Merawang	Bangka
Merbau	Kepulauan Meranti
Merbau Mataram	Lampung Selatan
Merdeka	Karo
Merdey	Teluk Bintuni
Merek	Karo
Mergangsan	Yogyakarta
Merigi	Kepahiang
Merigi Kelindang	Bengkulu Tengah
Merigi Sakti	Bengkulu Tengah
Merlung	Tanjung Jabung Barat
Mersam	Batang Hari
Mertoyudan	Magelang
Mesidah	Bener Meriah
Mesjid Raya	Aceh Besar
Messawa	Mamasa
Mestong	Muaro Jambi
Mesuji	Ogan Komering Ilir
Mesuji	Mesuji
Mesuji Makmur	Ogan Komering Ilir
Mesuji Raya	Ogan Komering Ilir
Mesuji Timur	Mesuji
Metro Barat	Metro
Metro Kibang	Lampung Timur
Metro Pusat	Metro
Metro Selatan	Metro
Metro Timur	Metro
Metro Utara	Metro
Meukek	Aceh Selatan
Meurah Dua	Pidie Jaya
Meurah Mulia	Aceh Utara
Meuraxa	Banda Aceh
Meureubo	Aceh Barat
Meureudu	Pidie Jaya
Mewoluk	Puncak Jaya
Meyado (Mayado)	Teluk Bintuni
Miangas	Kepulauan Talaud
Midai	Natuna
Mihing Raya	Gunung Mas
Mijen	Demak
Mijen	Semarang
Mila	Pidie
Milimbo	Lanny Jaya
Mimika Barat	Mimika
Mimika Barat Jauh	Mimika
Mimika Barat Tengah	Mimika
Mimika Baru	Mimika
Mimika Tengah	Mimika
Mimika Timur	Mimika
Mimika Timur Jauh	Mimika
Minas	Siak
Minasa Tene	Pangkajene Kepulauan
Mindiptana	Boven Digoel
Minggir	Sleman
Minyambaouw	Pegunungan Arfak
Minyamur	Mappi
Miomaffo Tengah (Miomafo Tengah)	Timor Tengah Utara
Miomafo Barat	Timor Tengah Utara
Miomafo Timur	Timor Tengah Utara
Miri	Sragen
Miri Manasa	Gunung Mas
Mirit	Kebumen
Misool (Misool Utara)	Raja Ampat
Misool Barat	Raja Ampat
Misool Selatan	Raja Ampat
Misool Timur	Raja Ampat
Miyah	Tambrauw
Miyah Selatan	Tambrauw
Mlandingan	Situbondo
Mlarak	Ponorogo
Mlati	Sleman
Mlonggo	Jepara
Mndona Hiera (Mdona Hyera / Hiera)	Maluku Barat Daya
Moa Lakor	Maluku Barat Daya
Moba	Nduga
Modayag	Bolaang Mongondow Timur
Modayag Barat	Bolaang Mongondow Timur
Modo	Lamongan
Modoinding	Minahasa Selatan
Modung	Bangkalan
Mofinop	Pegunungan Bintang
Moga	Pemalang
Moilong	Banggai
Moisegen	Sorong
Mojo	Kediri
Mojoagung	Jombang
Mojoanyar	Mojokerto
Mojogedang	Karanganyar
Mojolaban	Sukoharjo
Mojoroto	Kediri
Mojosari	Mojokerto
Mojosongo	Boyolali
Mojotengah	Wonosobo
Mojowarno	Jombang
Mokoni	Lanny Jaya
Molagalome	Jayawijaya
Molanikime	Puncak Jaya
Molawe	Konawe Utara
Mollo Barat	Timor Tengah Selatan
Mollo Selatan	Timor Tengah Selatan
Mollo Tengah	Timor Tengah Selatan
Mollo Utara	Timor Tengah Selatan
Molu Maru	Kepulauan Tanimbar (Maluku Tenggara Barat)
Momi Waren	Manokwari Selatan
Momunu	Buol
Monano	Gorontalo Utara
Moncong Loe (Moncongloe)	Maros
Mondokan	Sragen
Monta	Bima
Montallat (Montalat)	Barito Utara
Monterado	Bengkayang
Montong	Tuban
Montong Gading	Lombok Timur
Mooat	Bolaang Mongondow Timur
Mook Manaar Bulatn	Kutai Barat
Moora	Nabire
Mootilango	Gorontalo
Moraid	Tambrauw
Moramo	Konawe Selatan
Moramo Utara	Konawe Selatan
Mori Atas	Morowali Utara
Mori Utara	Morowali Utara
Moro	Karimun
Moro'o	Nias Barat
Moronge	Kepulauan Talaud
Morosi	Konawe
Morotai Jaya	Pulau Morotai
Morotai Selatan	Pulau Morotai
Morotai Selatan Barat	Pulau Morotai
Morotai Timur	Pulau Morotai
Morotai Utara	Pulau Morotai
Moskona Barat	Teluk Bintuni
Moskona Selatan	Teluk Bintuni
Moskona Timur	Teluk Bintuni
Moskona Utara	Teluk Bintuni
Moswaren	Sorong Selatan
Moti	Ternate
Motoling	Minahasa Selatan
Motoling Barat	Minahasa Selatan
Motoling Timur	Minahasa Selatan
Motongkad	Bolaang Mongondow Timur
Motui	Konawe Utara
Moutong	Parigi Moutong
Mowewe	Kolaka Timur
Mowila	Konawe Selatan
Moyo Hilir	Sumbawa
Moyo Hulu	Sumbawa
Moyo Utara	Sumbawa
Moyudan	Sleman
Mpunda	Bima
Mpur	Tambrauw
Mranggen	Demak
Mrebet	Purbalingga
Muara	Tapanuli Utara
Muara	Lanny Jaya
Muara	Puncak Jaya
Muara Ancalong	Kutai Timur
Muara Badak	Kutai Kartanegara
Muara Bangka Hulu	Bengkulu
Muara Batang Gadis	Mandailing Natal
Muara Batang Toru	Tapanuli Selatan
Muara Batu	Aceh Utara
Muara Belida	Muara Enim
Muara Beliti	Musi Rawas
Muara Bengkal	Kutai Timur
Muara Bulian	Batang Hari
Muara Dua	Lhokseumawe
Muara Dua (Muaradua)	Ogan Komering Ulu Selatan
Muara Dua Kisam (Muaradua Kisam)	Ogan Komering Ulu Selatan
Muara Enim	Muara Enim
Muara Harus	Tabalong
Muara Jawa	Kutai Kartanegara
Muara Jaya	Ogan Komering Ulu
Muara Kaman	Kutai Kartanegara
Muara Kelingi	Musi Rawas
Muara Kemumu	Kepahiang
Muara Komam	Paser
Muara Kuang	Ogan Ilir
Muara Lakitan	Musi Rawas
Muara Lawa	Kutai Barat
Muara Muntai	Kutai Kartanegara
Muara Padang	Banyuasin
Muara Pahu	Kutai Barat
Muara Papalik	Tanjung Jabung Barat
Muara Pawan	Ketapang
Muara Pinang	Empat Lawang
Muara Sabak Barat	Tanjung Jabung Timur
Muara Sabak Timur	Tanjung Jabung Timur
Muara Sahung	Kaur
Muara Samu	Paser
Muara Satu	Lhokseumawe
Muara Siau	Merangin
Muara Sipongi	Mandailing Natal
Muara Sugihan	Banyuasin
Muara Sungkai	Lampung Utara
Muara Tabir	Tebo
Muara Tami	Jayapura
Muara Telang	Banyuasin
Muara Tembesi	Batang Hari
Muara Tiga	Pidie
Muara Uya	Tabalong
Muara Wahau	Kutai Timur
Muara Wis	Kutai Kartanegara
Muaragembong (Muara Gembong)	Bekasi
Muarapayang	Lahat
Mubrani	Tambrauw
Mugi	Nduga
Mugi	Yahukimo
Muko-muko Bathin / Batin VII	Bungo
Mukok	Sanggau
Mulak Sebingkai	Lahat
Mulak Ulu	Lahat
Mulia	Puncak Jaya
Muliama	Jayawijaya
Mulyorejo	Surabaya
Mumbulsari	Jember
Muncang	Lebak
Muncar	Banyuwangi
Mundu	Cirebon
Mungka	Lima Puluh Kota
Mungkajang	Palopo
Mungkid	Magelang
Munjul	Pandeglang
Munjungan	Trenggalek
Munte	Karo
Muntilan	Magelang
Murhum	Bau-Bau
Murkim	Pegunungan Bintang
Muruk Rian	Tana Tidung
Murung	Murung Raya
Murung Pudak	Tabalong
Musaik	Yahukimo
Musatfak	Jayawijaya
Musi	Timor Tengah Utara
Mustikajaya (Mustika Jaya)	Bekasi
Musuk	Boyolali
Mutiara	Pidie
Mutiara Timur	Pidie
Muting	Merauke
Mutis	Timor Tengah Utara
Muye	Paniai
Na IX-X	Labuhanbatu Utara
Nabire	Nabire
Nabire Barat	Nabire
Nabunage	Tolikara
Naga Juang	Mandailing Natal
Naga Wutung	Lembata
Nagrak	Sukabumi
Nagreg	Bandung
Naibenu	Timor Tengah Utara
Naikere	Teluk Wondama
Nainggolan	Samosir
Nakama	Paniai
Nalca	Yahukimo
Nalo Tatan (Nalo Tantan)	Merangin
Nalumsari	Jepara
Naman Teran (Nama Teran)	Karo
Namang	Bangka Tengah
Nambluong	Jayapura
Nambo	Banggai
Namlea	Buru
Namohalu Esiwa	Nias Utara
Namorambe (Namo Rambe)	Deli Serdang
Namrole	Buru Selatan
Nan Sabaris	Padang Pariaman
Nanaet Duabesi	Belu
Nanga Mahap	Sekadau
Nanga Pinoh	Melawi
Nanga Taman	Sekadau
Nanga Tayap	Ketapang
Nangapanda	Ende
Nangaroro	Nagekeo
Nanggala	Toraja Utara
Nanggalo	Padang
Nanggulan	Kulon Progo
Nanggung	Bogor
Nanusa	Kepulauan Talaud
Napabalano	Muna
Napal Putih	Bengkulu Utara
Napan	Nabire
Napano Kusambi	Muna Barat
Napua	Jayawijaya
Naringgul	Cianjur
Narmada	Lombok Barat
Nasal	Kaur
Nassau	Toba Samosir
Natal	Mandailing Natal
Natar	Lampung Selatan
Naukenjerai	Merauke
Nawangan	Pacitan
Ndao Nuse	Rote Ndao
Ndona	Ende
Ndona Timur	Ende
Ndori	Ende
Ndoso	Manggarai Barat
Negara	Jembrana
Negara Batin	Way Kanan
Negeri Agung	Way Kanan
Negeri Besar	Way Kanan
Negeri Katon	Pesawaran
Neglasari	Tangerang
Nekamese	Kupang
Nelawi	Tolikara
Nelle (Maumerei)	Sikka
Neney	Manokwari Selatan
Nenggeagin	Nduga
Ngabang	Landak
Ngablak	Magelang
Ngadiluwih	Kediri
Ngadirejo	Temanggung
Ngadirojo	Wonogiri
Ngadirojo	Pacitan
Ngadu Ngala	Sumba Timur
Ngaglik	Sleman
Ngajung (Ngajum)	Malang
Ngaliyan	Semarang
Ngambon	Bojonegoro
Ngambur	Pesisir Barat
Ngampel	Kendal
Ngampilan	Yogyakarta
Ngamprah	Bandung Barat
Ngancar	Kediri
Nganjuk	Nganjuk
Ngantang	Malang
Ngantru	Tulungagung
Ngapa	Kolaka Utara
Ngaras (Bengkunat Belimbing)	Pesisir Barat
Ngargoyoso	Karanganyar
Ngariboyo	Magetan
Ngaringan	Grobogan
Ngasem	Bojonegoro
Ngasem	Kediri
Ngawen	Gunung Kidul
Ngawen	Blora
Ngawen	Klaten
Ngawi	Ngawi
Ngebel	Ponorogo
Ngemplak	Sleman
Ngemplak	Boyolali
Ngetos	Nganjuk
Nggaha Ori Angu (Nggaha Oriangu)	Sumba Timur
Ngguti	Merauke
Ngimbang	Lamongan
Nglegok	Blitar
Nglipar	Gunung Kidul
Ngluwar	Magelang
Ngluyu	Nganjuk
Ngombol	Purworejo
Ngoro	Jombang
Ngoro	Mojokerto
Ngraho	Bojonegoro
Ngrambe	Ngawi
Ngrampal	Sragen
Ngrayun	Ponorogo
Ngronggot	Nganjuk
Nguling	Pasuruan
Nguntoronadi	Magetan
Nguntoronadi	Wonogiri
Ngunut	Tulungagung
Ngusikan	Jombang
Nguter	Sukoharjo
Nibong	Aceh Utara
Nibung	Musi Rawas Utara
Nibung Hangus	Batu Bara
Nikiwar	Teluk Wondama
Nikogwe	Lanny Jaya
Nimbokrang	Jayapura
Nimboran	Jayapura
Niname	Lanny Jaya
Ninati	Boven Digoel
Ninia	Yahukimo
Nioga	Puncak Jaya
Nipah Panjang	Tanjung Jabung Timur
Nipsan	Yahukimo
Nirkuri	Nduga
Nirunmas	Kepulauan Tanimbar (Maluku Tenggara Barat)
Nisam	Aceh Utara
Nisam Antara	Aceh Utara
Nita	Sikka
Noebana	Timor Tengah Selatan
Noebeba	Timor Tengah Selatan
Noemuti	Timor Tengah Utara
Noemuti Timur	Timor Tengah Utara
Nogi	Lanny Jaya
Nogosari	Boyolali
Nokilalaki	Sigi
Nonggunong	Sumenep
Nongme	Pegunungan Bintang
Nongsa	Batam
Nosu	Mamasa
Noyan	Sanggau
Nuangan	Bolaang Mongondow Timur
Nubatukan	Lembata
Nuha	Luwu Timur
Nuhon	Banggai
Numba	Tolikara
Nume	Puncak Jaya
Numfor Barat	Biak Numfor
Numfor Timur	Biak Numfor
Nunbena	Timor Tengah Selatan
Nunggawi (Munggawi)	Tolikara
Nunkolo	Timor Tengah Selatan
Nunukan	Nunukan
Nunukan Selatan	Nunukan
Nurussalam	Aceh Timur
Nusa Laut	Maluku Tengah
Nusa Penida (Nusapenida)	Klungkung
Nusa Tabukan	Kepulauan Sangihe
Nusaherang	Kuningan
Nusaniwe (Nusanive)	Ambon
Nusawungu	Cilacap
Nyalindung	Sukabumi
Nyuatan	Kutai Barat
O'o'u (Oou)	Nias Selatan
Oba	Tidore Kepulauan
Oba Selatan	Tidore Kepulauan
Oba Tengah	Tidore Kepulauan
Oba Utara	Tidore Kepulauan
Obaa	Mappi
Obi	Halmahera Selatan
Obi Barat	Halmahera Selatan
Obi Selatan	Halmahera Selatan
Obi Timur	Halmahera Selatan
Obi Utara	Halmahera Selatan
Obio	Yahukimo
Oebobo	Kupang
Oenino	Timor Tengah Selatan
Ogamanim	Puncak
Ogodeide	Toli-Toli
Oheo	Konawe Utara
Ok Aom	Pegunungan Bintang
Okaba	Merauke
Okbab	Pegunungan Bintang
Okbape	Pegunungan Bintang
Okbemtau	Pegunungan Bintang
Okbibab	Pegunungan Bintang
Okhika	Pegunungan Bintang
Oklip	Pegunungan Bintang
Oksamol	Pegunungan Bintang
Oksebang	Pegunungan Bintang
Oksibil	Pegunungan Bintang
Oksop	Pegunungan Bintang
Omben	Sampang
Omesuri	Lembata
Omukia	Puncak
Onan Ganjang	Humbang Hasundutan
Onan Runggu	Samosir
Onembute	Konawe
Oneri	Puncak
Ongka Malino	Parigi Moutong
Onohazumba	Nias Selatan
Onolalu	Nias Selatan
Oransbari	Manokwari Selatan
Oridek	Biak Numfor
Orkeri	Biak Numfor
Orong Telu	Sumbawa
Oudate	Waropen
Paal Dua	Manado
Paal Merah	Jambi
Pabean Cantian (Pabean Cantikan)	Surabaya
Pabedilan	Cirebon
Pabelan	Semarang
Paberiwai	Sumba Timur
Pabuaran	Serang
Pabuaran	Cirebon
Pabuaran	Subang
Pabuaran	Sukabumi
Pacar	Manggarai Barat
Pace	Nganjuk
Pacet	Mojokerto
Pacet	Bandung
Pacet	Cianjur
Paciran	Lamongan
Pacitan	Pacitan
Padaherang	Pangandaran
Padaido	Biak Numfor
Padakembang	Tasikmalaya
Padalarang	Bandung Barat
Padamara	Purbalingga
Padang	Lumajang
Padang Barat	Padang
Padang Batung	Hulu Sungai Selatan
Padang Bolak	Padang Lawas Utara
Padang Bolak Julu	Padang Lawas Utara
Padang Bolak Tenggara	Padang Lawas Utara
Padang Cermin	Pesawaran
Padang Ganting	Tanah Datar
Padang Gelugur	Pasaman
Padang Guci Hilir	Kaur
Padang Guci Hulu	Kaur
Padang Hilir	Tebing Tinggi
Padang Hulu	Tebing Tinggi
Padang Jaya	Bengkulu Utara
Padang Laweh	Dharmasraya
Padang Panjang Barat	Padang Panjang
Padang Panjang Timur	Padang Panjang
Padang Ratu	Lampung Tengah
Padang Sago	Padang Pariaman
Padang Selatan	Padang
Padang Tiji	Pidie
Padang Timur	Padang
Padang Tualang	Langkat
Padang Ulak Tanding	Rejang Lebong
Padang Utara	Padang
Padangan	Bojonegoro
Padangguni	Konawe
Padangsidimpuan / Padang Sidempuan Angkola Julu	Padang Sidempuan
Padangsidimpuan / Padang Sidempuan Batunadua	Padang Sidempuan
Padangsidimpuan / Padang Sidempuan Hutaimbaru	Padang Sidempuan
Padangsidimpuan / Padang Sidempuan Selatan	Padang Sidempuan
Padangsidimpuan / Padang Sidempuan Tenggara	Padang Sidempuan
Padangsidimpuan / Padang Sidempuan Utara	Padang Sidempuan
Padarincang	Serang
Padas	Ngawi
Pademangan	Jakarta Utara
Pademawu	Pamekasan
Padureso	Kebumen
Paga	Sikka
Pagaden	Subang
Pagaden Barat	Subang
Pagai Selatan	Kepulauan Mentawai
Pagai Utara	Kepulauan Mentawai
Pagak	Malang
Pagaleme	Puncak Jaya
Pagar Alam Selatan	Pagar Alam
Pagar Alam Utara	Pagar Alam
Pagar Dewa	Lampung Barat
Pagar Dewa	Tulang Bawang Barat
Pagar Gunung	Lahat
Pagar Jati	Bengkulu Tengah
Pagar Merbau	Deli Serdang
Pagaran	Tapanuli Utara
Pagaran Tapah Darussalam	Rokan Hulu
Pagedangan	Tangerang
Pagedongan	Banjarnegara
Pagelaran	Pandeglang
Pagelaran	Cianjur
Pagelaran	Malang
Pagelaran	Pringsewu
Pagelaran Utara	Pringsewu
Pagentan	Banjarnegara
Pagerageung	Tasikmalaya
Pagerbarang	Tegal
Pageruyung (Pagerruyung)	Kendal
Pagerwojo	Tulungagung
Pagimana	Banggai
Pagindar	Pakpak Bharat
Pagu	Kediri
Paguat	Pohuwato
Paguyaman	Boalemo
Paguyaman Pantai	Boalemo
Paguyangan	Brebes
Pahae Jae	Tapanuli Utara
Pahae Julu	Tapanuli Utara
Pahandut	Palangka Raya
Pahunga Lodu	Sumba Timur
Paiton	Probolinggo
Pajangan	Bantul
Pajar Bulan	Lahat
Pajo	Dompu
Paju Epat	Barito Timur
Pajukukang	Bantaeng
Pakal	Surabaya
Pakantan	Mandailing Natal
Pakel	Tulungagung
Pakem	Sleman
Pakem	Bondowoso
Pakenjeng	Garut
Pakis	Magelang
Pakis	Malang
Pakis Aji	Jepara
Pakisaji	Malang
Pakisjaya	Karawang
Pakkat	Humbang Hasundutan
Pakong	Pamekasan
Paku	Barito Timur
Pakualaman	Yogyakarta
Pakuan Ratu	Way Kanan
Pakue	Kolaka Utara
Pakue Tengah	Kolaka Utara
Pakue Utara	Kolaka Utara
Pakuhaji	Tangerang
Pakuniran	Probolinggo
Pakusari	Jember
Pal Merah (Palmerah)	Jakarta Barat
Palabuhanratu (Pelabuhanratu)	Sukabumi
Palakka	Bone
Palang	Tuban
Palangga	Konawe Selatan
Palangga (Pallangga)	Gowa
Palangga Selatan	Konawe Selatan
Palaran	Samarinda
Palas	Lampung Selatan
Palasa	Parigi Moutong
Palasah	Majalengka
Paleleh	Buol
Paleleh Barat	Buol
Palenggaan (Palenga'an)	Pamekasan
Paleteang	Pinrang
Palibelo	Bima
Palimanan	Cirebon
Palipi	Samosir
Paliyan	Gunung Kidul
Palmatak	Kepulauan Anambas
Paloh	Sambas
Palolo	Sigi
Palu Barat	Palu
Palu Selatan	Palu
Palu Timur	Palu
Palu Utara	Palu
Palue	Sikka
Palupuh	Agam
Pamanukan	Subang
Pamarayan	Serang
Pamarican	Ciamis
Pamboang	Majene
Pamek	Pegunungan Bintang
Pamekasan	Pamekasan
Pamenang	Merangin
Pamenang Barat	Merangin
Pamenang Selatan	Merangin
Pameungpeuk	Bandung
Pameungpeuk	Garut
Pamijahan	Bogor
Paminggir	Hulu Sungai Utara
Pammana	Wajo
Pamona Barat	Poso
Pamona Puselemba	Poso
Pamona Selatan	Poso
Pamona Tenggara	Poso
Pamona Timur	Poso
Pamona Utara	Poso
Pamotan	Rembang
Pampangan	Ogan Komering Ilir
Pamukan Barat	Kotabaru
Pamukan Selatan	Kotabaru
Pamukan Utara	Kotabaru
Pamulang	Tangerang Selatan
Pamulihan	Garut
Pamulihan	Sumedang
Pana	Mamasa
Panaga	Tolikara
Panai Hilir	Labuhanbatu
Panai Hulu	Labuhanbatu
Panai Tengah	Labuhanbatu
Panakkukang	Makassar
Panang Enim	Muara Enim
Panarukan	Situbondo
Panawangan	Ciamis
Panca Jaya	Mesuji
Panca Lautan (Lautang)	Sidenreng Rappang
Panca Rijang	Sidenreng Rappang
Pancalang	Kuningan
Pancatengah	Tasikmalaya
Panceng	Gresik
Pancoran	Jakarta Selatan
Pancoran Mas	Depok
Pancung Soal	Pesisir Selatan
Pancur	Rembang
Pancur Batu	Deli Serdang
Pandaan	Pasuruan
Pandak	Bantul
Pandan	Tapanuli Tengah
Pandanarum	Banjarnegara
Pandawai	Sumba Timur
Pandawan	Hulu Sungai Tengah
Pandeglang	Pandeglang
Pandih Batu	Pulang Pisau
Pandrah	Bireuen
Panei	Simalungun
Panekan	Magetan
Panga (Keude Panga)	Aceh Jaya
Pangale	Mamuju Tengah
Pangalengan	Bandung
Pangandaran	Pangandaran
Pangarengan	Sampang
Pangaribuan	Tapanuli Utara
Pangatikan	Garut
Pangean	Kuantan Singingi
Pangenan	Cirebon
Panggang	Gunung Kidul
Panggarangan	Lebak
Panggema	Yahukimo
Panggul	Trenggalek
Panggungrejo	Blitar
Panggungrejo	Pasuruan
Pangkah	Tegal
Pangkajene	Pangkajene Kepulauan
Pangkal Balam	Pangkal Pinang
Pangkalan	Karawang
Pangkalan Banteng	Kotawaringin Barat
Pangkalan Baru	Bangka Tengah
Pangkalan Jambu	Merangin
Pangkalan Kerinci	Pelalawan
Pangkalan Koto Baru	Lima Puluh Kota
Pangkalan Kuras	Pelalawan
Pangkalan Lada	Kotawaringin Barat
Pangkalan Lampam	Ogan Komering Ilir
Pangkalan Lesung	Pelalawan
Pangkalan Susu	Langkat
Pangkatan	Labuhanbatu
Pangkur	Ngawi
Panguragan	Cirebon
Pangururan	Samosir
Paniai Barat	Paniai
Paniai Timur	Paniai
Panimbang	Pandeglang
Paninggaran	Pekalongan
Panjalu	Ciamis
Panjang	Bandar Lampung
Panjatan	Kulon Progo
Panji	Situbondo
Panombeian Pane	Simalungun
Panongan	Tangerang
Pantai Barat	Sarmi
Pantai Baru	Rote Ndao
Pantai Cermin	Serdang Bedagai
Pantai Cermin	Solok
Pantai Kasuari	Asmat
Pantai Labu	Deli Serdang
Pantai Lunci	Sukamara
Pantai Timur	Sarmi
Pantai Timur Bagian Barat	Sarmi
Pantan Cuaca	Gayo Lues
Pantar	Alor
Pantar Barat	Alor
Pantar Baru Laut (Pantar Barat Laut)	Alor
Pantar Tengah	Alor
Pantar Timur	Alor
Pante Bidari	Aceh Timur
Pante Ceureumen (Pantai Ceuremen)	Aceh Barat
Panteraja	Pidie Jaya
Panti	Jember
Panti	Pasaman
Panton Reu	Aceh Barat
Panumbangan	Ciamis
Panyabungan	Mandailing Natal
Panyabungan Barat	Mandailing Natal
Panyabungan Selatan	Mandailing Natal
Panyabungan Timur	Mandailing Natal
Panyabungan Utara	Mandailing Natal
Panyileukan	Bandung
Panyingkiran	Majalengka
Panyipatan	Tanah Laut
Papalang	Mamuju
Papar	Kediri
Parado	Bima
Parakan	Temanggung
Parakansalak (Parakan Salak)	Sukabumi
Paramasan (Peramasan)	Banjar
Parang	Magetan
Paranggupito	Wonogiri
Paranginan	Humbang Hasundutan
Parangloe	Gowa
Parbuluan	Dairi
Pardasuka	Pringsewu
Pare	Kediri
Parengan	Tuban
Parenggean	Kotawaringin Timur
Pariaman Selatan	Pariaman
Pariaman Tengah	Pariaman
Pariaman Timur	Pariaman
Pariaman Utara	Pariaman
Pariangan	Tanah Datar
Parigi	Gowa
Parigi	Parigi Moutong
Parigi	Muna
Parigi	Pangandaran
Parigi Barat	Parigi Moutong
Parigi Selatan	Parigi Moutong
Parigi Tengah	Parigi Moutong
Parigi Utara	Parigi Moutong
Parindu	Sanggau
Paringin	Balangan
Paringin Selatan	Balangan
Parittiga	Bangka Barat
Pariwari	Fakfak
Parlilitan	Humbang Hasundutan
Parmaksian	Toba Samosir
Parmonangan	Tapanuli Utara
Paro	Nduga
Paron	Ngawi
Parongpong	Bandung Barat
Parung	Bogor
Parung Panjang	Bogor
Parungkuda (Parung Kuda)	Sukabumi
Parungponteng	Tasikmalaya
Pasak Talawang	Kapuas
Pasaleman	Cirebon
Pasaman	Pasaman Barat
Pasan	Minahasa Tenggara
Pasangkayu	Pasangkayu (Mamuju Utara)
Pasar Jambi	Jambi
Pasar Kemis	Tangerang
Pasar Kliwon	Surakarta
Pasar Manna	Bengkulu Selatan
Pasar Minggu	Jakarta Selatan
Pasar Muaro Bungo (Pasar Muara Bungo)	Bungo
Pasar Rebo	Jakarta Timur
Pasaribu Tobing	Tapanuli Tengah
Pasarwajo (Pasar Wajo)	Buton
Pasawahan	Kuningan
Pasawahan	Purwakarta
Pasean	Pamekasan
Paseh	Bandung
Paseh	Sumedang
Pasekan	Indramayu
Pasema	Yahukimo
Pasemah Air Keruh	Empat Lawang
Paser Belengkong (Pasir Belengkong)	Paser
Pasi Kolaga	Muna
Pasi Raja (Pasie Raja)	Aceh Selatan
Pasie Raya	Aceh Jaya
Pasilambena	Kepulauan Selayar
Pasimarannu	Kepulauan Selayar
Pasimasunggu (Pasimassunggu)	Kepulauan Selayar
Pasimasunggu Timur	Kepulauan Selayar
Pasir Limau Kapas	Rokan Hilir
Pasir Penyu	Indragiri Hulu
Pasir Putih	Muna
Pasir Putih	Nduga
Pasir Sakti	Lampung Timur
Pasirian	Lumajang
Pasirjambu	Bandung
Pasirkuda	Cianjur
Pasirwangi	Garut
Pasongsongan	Sumenep
Pasrepan	Pasuruan
Pasrujambe/Pasujambe	Lumajang
Passi Barat	Bolaang Mongondow
Passi Timur	Bolaang Mongondow
Passue	Mappi
Passue Bawah	Mappi
Patampanua	Pinrang
Patamuan	Padang Pariaman
Patangkep Tutui	Barito Timur
Patani	Halmahera Tengah
Patani Barat	Halmahera Tengah
Patani Timur	Halmahera Tengah
Patani Utara	Halmahera Tengah
Pataruman	Banjar
Patean	Kendal
Patebon	Kendal
Pati	Pati
Patia	Pandeglang
Patianrowo	Nganjuk
Patikraja	Banyumas
Patilanggio	Pohuwato
Patimpeng	Bone
Patimuan	Cilacap
Patokbeusi	Subang
Patrang	Jember
Patrol	Indramayu
Pattalasang (Pattallassang)	Gowa
Pattallassang (Patallassang)	Takalar
Patuk	Gunung Kidul
Patumbak	Deli Serdang
Pauh	Sarolangun
Pauh	Padang
Pauh Duo	Solok Selatan
Paya Bakong	Aceh Utara
Payakumbuh	Lima Puluh Kota
Payakumbuh Barat	Payakumbuh
Payakumbuh Selatan	Payakumbuh
Payakumbuh Timur	Payakumbuh
Payakumbuh Utara	Payakumbuh
Payangan	Gianyar
Payaraman	Ogan Ilir
Payung	Bangka Selatan
Payung	Karo
Payung Sekaki	Pekanbaru
Payung Sekaki	Solok
Pebayuran	Bekasi
Pecalungan	Batang
Pecangaan	Jepara
Pedamaran	Ogan Komering Ilir
Pedamaran Timur	Ogan Komering Ilir
Pedan	Klaten
Pedes	Karawang
Pedongga	Pasangkayu (Mamuju Utara)
Pedurungan	Semarang
Pegagan Hilir	Dairi
Pegajahan	Serdang Bedagai
Pegandon	Kendal
Pegantenan	Pamekasan
Pegasing	Aceh Tengah
Pejagoan	Kebumen
Pejarakan (Pajarakan)	Probolinggo
Pejawaran	Banjarnegara
Pekaitan	Rokan Hilir
Pekalipan	Cirebon
Pekalongan	Lampung Timur
Pekalongan Barat	Pekalongan
Pekalongan Selatan	Pekalongan
Pekalongan Timur	Pekalongan
Pekalongan Utara	Pekalongan
Pekanbaru Kota	Pekanbaru
Pekat	Dompu
Pekuncen	Banyumas
Pekutatan	Jembrana
Pelabai	Lebong
Pelaihari	Tanah Laut
Pelalawan	Pelalawan
Pelangiran	Indragiri Hilir
Pelawan	Sarolangun
Pelayangan	Jambi
Pelebaga	Jayawijaya
Pelembayan (Palembayan)	Agam
Pelepat	Bungo
Pelepat Ilir	Bungo
Peling Tengah	Banggai Kepulauan
Pemahan	Ketapang
Pemalang	Pemalang
Pemali	Bangka
Pemangkat	Sambas
Pematang / Pamatang Silima Huta	Simalungun
Pematang Bandar	Simalungun
Pematang Jaya	Langkat
Pematang Karau	Barito Timur
Pematang Sawa	Tanggamus
Pematang Sidamanik	Simalungun
Pematang Tiga	Bengkulu Tengah
Pemayung	Batang Hari
Pemenang	Lombok Utara
Pemulutan	Ogan Ilir
Pemulutan Barat	Ogan Ilir
Pemulutan Selatan	Ogan Ilir
Penajam	Penajam Paser Utara
Penanggalan	Subulussalam
Penarik	Muko Muko
Penawangan	Grobogan
Penawar Aji	Tulang Bawang
Penawar Tama	Tulang Bawang
Pendalian IV Koto	Rokan Hulu
Pendopo	Empat Lawang
Pendopo Barat	Empat Lawang
Penebel	Tabanan
Penengahan	Lampung Selatan
Pengabuan	Tanjung Jabung Barat
Pengadegan	Purbalingga
Pengandonan	Ogan Komering Ulu
Pengarom (Pengaron)	Banjar
Pengasih	Kulon Progo
Pengkadan (Batu Datu)	Kapuas Hulu
Peninjauan	Ogan Komering Ulu
Penjaringan	Jakarta Utara
Penrang	Wajo
Penukal	Penukal Abab Lematang Ilir
Penukal Utara	Penukal Abab Lematang Ilir
Penyinggahan	Kutai Barat
Pepera	Pegunungan Bintang
Perak	Jombang
Peranap	Indragiri Hulu
Perbaungan	Serdang Bedagai
Percut Sei Tuan	Deli Serdang
Pergetteng Getteng Sengkut	Pakpak Bharat
Perhentian Raja	Kampar
Periuk	Tangerang
Permata	Bener Meriah
Permata Intan	Murung Raya
Permata Kecubung	Sukamara
Pesanggaran	Banyuwangi
Pesanggrahan	Jakarta Selatan
Pesantren	Kediri
Pesisir Bukit	Sungaipenuh
Pesisir Selatan	Pesisir Barat
Pesisir Tengah	Pesisir Barat
Pesisir Utara	Pesisir Barat
Peso	Bulungan
Peso Hilir/Ilir	Bulungan
Petak Malai	Katingan
Petanahan	Kebumen
Petang	Badung
Petarukan	Pemalang
Petasia	Morowali Utara
Petasia Barat	Morowali Utara
Petasia Timur	Morowali Utara
Peterongan	Jombang
Petir	Serang
Petungkriono/Petungkriyono	Pekalongan
Peudada	Bireuen
Peudawa	Aceh Timur
Peukan Bada	Aceh Besar
Peukan Baro	Pidie
Peulimbang (Plimbang)	Bireuen
Peunaron	Aceh Timur
Peundeuy	Garut
Peureulak	Aceh Timur
Peureulak Barat	Aceh Timur
Peureulak Timur	Aceh Timur
Peusangan	Bireuen
Peusangan Selatan	Bireuen
Peusangan Siblah Krueng	Bireuen
Piani	Tapin
Picung	Pandeglang
Pidie	Pidie
Pija	Nduga
Pilangkenceng	Madiun
Pinang (Penang)	Tangerang
Pinang Belapis	Lebong
Pinang Raya	Bengkulu Utara
Pinangsori	Tapanuli Tengah
Pineleng	Minahasa
Pinembani (Panembani)	Donggala
Pinggir	Bengkalis
Pining (Pinding)	Gayo Lues
Pino	Bengkulu Selatan
Pino Raya (Pinoraya)	Bengkulu Selatan
Pinogaluman	Bolaang Mongondow Utara
Pinogu	Bone Bolango
Pinoh Selatan	Melawi
Pinoh Utara	Melawi
Pinolosian	Bolaang Mongondow Selatan
Pinolosian Tengah	Bolaang Mongondow Selatan
Pinolosian Timur	Bolaang Mongondow Selatan
Pintu Pohan Meranti	Toba Samosir
Pintu Rime Gayo	Bener Meriah
Pinu Pahar (Pinupahar / Pirapahar)	Sumba Timur
Pipikoro	Sigi
Pirak Timur	Aceh Utara
Piramid	Jayawijaya
Pirime	Lanny Jaya
Pisugi	Jayawijaya
Pitu	Ngawi
Pitu Raise/Riase	Sidenreng Rappang
Pitu Riawa	Sidenreng Rappang
Pitumpanua	Wajo
Pituruh	Purworejo
Piyaiye (Sukikai)	Dogiyai
Piyungan	Bantul
Plaju	Palembang
Plakat Tinggi (Pelakat Tinggi)	Musi Banyuasin
Plampang	Sumbawa
Plandaan	Jombang
Plantungan	Kendal
Plaosan	Magetan
Playen	Gunung Kidul
Plemahan	Kediri
Plered	Cirebon
Plered	Purwakarta
Pleret	Bantul
Ploso	Jombang
Plosoklaten	Kediri
Plumbon	Cirebon
Plumpang	Tuban
Plupuh	Sragen
Poasia	Kendari
Poco Ranaka	Manggarai Timur
Poco Ranaka Timur	Manggarai Timur
Poga	Lanny Jaya
Pogalan	Trenggalek
Poganeri	Tolikara
Pogoma	Puncak
Pohjentrek	Pasuruan
Poigar	Bolaang Mongondow
Poiru	Biak Numfor
Polanharjo	Klaten
Poleang	Bombana
Poleang Barat	Bombana
Poleang Selatan	Bombana
Poleang Tengah	Bombana
Poleang Tenggara	Bombana
Poleang Timur	Bombana
Poleang Utara	Bombana
Polen	Timor Tengah Selatan
Polewali	Polewali Mandar
Poli Polia	Kolaka Timur
Polinggona	Kolaka
Pollung	Humbang Hasundutan
Polokarto	Sukoharjo
Polombangkeng Selatan (Polobangkeng)	Takalar
Polombangkeng Utara (Polobangkeng)	Takalar
Pomalaa	Kolaka
Poncokusumo	Malang
Poncol	Magetan
Poncowarno	Kebumen
Pondidaha	Konawe
Pondok Aren	Tangerang Selatan
Pondok Kelapa	Bengkulu Tengah
Pondok Kubang	Bengkulu Tengah
Pondok Suguh	Muko Muko
Pondok Tinggi	Sungaipenuh
Pondokgede (Pondok Gede)	Bekasi
Pondokmelati (Pondok Melati)	Bekasi
Pondoksalam	Purwakarta
Ponelo Kepulauan	Gorontalo Utara
Ponggok	Blitar
Ponjong	Gunung Kidul
Ponorogo	Ponorogo
Ponrang	Luwu
Ponrang Selatan	Luwu
Ponre	Bone
Pontang	Serang
Pontianak Barat	Pontianak
Pontianak Kota	Pontianak
Pontianak Selatan	Pontianak
Pontianak Tenggara	Pontianak
Pontianak Timur	Pontianak
Pontianak Utara	Pontianak
Poom	Kepulauan Yapen
Popayato	Pohuwato
Popayato Barat	Pohuwato
Popayato Timur	Pohuwato
Popugoba	Jayawijaya
Porehu	Kolaka Utara
Porong	Sidoarjo
Porsea	Toba Samosir
Portibi	Padang Lawas Utara
Posigadan	Bolaang Mongondow Selatan
Poso Kota	Poso
Poso Kota Selatan	Poso
Poso Kota Utara	Poso
Poso Pesisir	Poso
Poso Pesisir Selatan	Poso
Poso Pesisir Utara	Poso
Poto Tano	Sumbawa Barat
Prabumulih Barat	Prabumulih
Prabumulih Selatan	Prabumulih
Prabumulih Timur	Prabumulih
Prabumulih Utara	Prabumulih
Pracimantoro	Wonogiri
Prafi	Manokwari
Pragaan	Sumenep
Prajekan	Bondowoso
Prajuritkulon (Prajurit Kulon)	Mojokerto
Prambanan	Sleman
Prambanan	Klaten
Prambon	Nganjuk
Prambon	Sidoarjo
Praya	Lombok Tengah
Praya Barat	Lombok Tengah
Praya Barat Daya	Lombok Tengah
Praya Tengah	Lombok Tengah
Praya Timur	Lombok Tengah
Prembun	Kebumen
Prigen	Pasuruan
Pringapus	Semarang
Pringgabaya	Lombok Timur
Pringgarata	Lombok Tengah
Pringgasela	Lombok Timur
Pringkuku	Pacitan
Pringsewu	Pringsewu
Pringsurat	Temanggung
Pronggoli (Proggoli)	Yahukimo
Pronojiwo	Lumajang
Proppo	Pamekasan
Pseksu	Lahat
Pubian	Lampung Tengah
Pucakwangi	Pati
Pucanglaban	Tulungagung
Pucuk	Lamongan
Pucuk Rantau	Kuantan Singingi
Pudak	Ponorogo
Puding Besar	Bangka
Pugaan	Tabalong
Puger	Jember
Pugo Dagi	Paniai
Pugung	Tanggamus
Puhpelem	Wonogiri
Pujananting	Barru
Pujer	Bondowoso
Pujon	Malang
Pujud	Rokan Hilir
Pujungan	Malinau
Pujut	Lombok Tengah
Pulau Banyak	Aceh Singkil
Pulau Banyak Barat	Aceh Singkil
Pulau Batang Dua	Ternate
Pulau Beringin	Ogan Komering Ulu Selatan
Pulau Burung	Indragiri Hilir
Pulau Derawan	Berau
Pulau Dullah Selatan	Tual
Pulau Dullah Utara	Tual
Pulau Ende	Ende
Pulau Gebe	Halmahera Tengah
Pulau Gorom	Seram Bagian Timur
Pulau Hanaut	Kotawaringin Timur
Pulau Haruku	Maluku Tengah
Pulau Hiri	Ternate
Pulau Kurudu	Kepulauan Yapen
Pulau Lakor	Maluku Barat Daya
Pulau Laut	Natuna
Pulau Laut / Pulaulaut Barat	Kotabaru
Pulau Laut / Pulaulaut Kepulauan	Kotabaru
Pulau Laut / Pulaulaut Selatan	Kotabaru
Pulau Laut / Pulaulaut Tanjung Selayar	Kotabaru
Pulau Laut / Pulaulaut Tengah	Kotabaru
Pulau Laut / Pulaulaut Timur	Kotabaru
Pulau Laut / Pulaulaut Utara	Kotabaru
Pulau Leti / Letti (Leti Moa Lakor)	Maluku Barat Daya
Pulau Makian	Halmahera Selatan
Pulau Malan	Katingan
Pulau Masela	Maluku Barat Daya
Pulau Maya (Pulau Maya Karimata)	Kayong Utara
Pulau Panggung	Tanggamus
Pulau Panjang	Seram Bagian Timur
Pulau Petak	Kapuas
Pulau Pulau Babar	Maluku Barat Daya
Pulau Pulau Terselatan	Maluku Barat Daya
Pulau Punjung	Dharmasraya
Pulau Pura	Alor
Pulau Rakyat	Asahan
Pulau Rimau	Banyuasin
Pulau Sebuku (Pulausebuku)	Kotabaru
Pulau Sembilan	Sinjai
Pulau Sembilan (Pulausembilan)	Kotabaru
Pulau Ternate	Ternate
Pulau Tiga	Natuna
Pulau Tiga	Asmat
Pulau Tiga Barat	Natuna
Pulau Wetang	Maluku Barat Daya
Pulau Yerui	Kepulauan Yapen
Pulau-Pulau Aru	Kepulauan Aru
Pulau-Pulau Babar Timur	Maluku Barat Daya
Pulau-Pulau Batu	Nias Selatan
Pulau-Pulau Batu Barat	Nias Selatan
Pulau-Pulau Batu Timur	Nias Selatan
Pulau-Pulau Batu Utara	Nias Selatan
Pulau-Pulau Kur	Tual
Pulaubesar (Pulau Besar)	Bangka Selatan
Pulaumerbau	Kepulauan Meranti
Pulaupinang (Pulau Pinang)	Lahat
Pulaupisang (Pulau Pisang)	Pesisir Barat
Puldama	Yahukimo
Pule	Trenggalek
Pulo Aceh	Aceh Besar
Pulo Ampel	Serang
Pulo Bandring	Asahan
Pulogadung (Pulo Gadung)	Jakarta Timur
Pulokulon	Grobogan
Pulomerak	Cilegon
Pulosari	Pandeglang
Pulosari	Pemalang
Pulubala	Gorontalo
Pulung	Ponorogo
Pulutan	Kepulauan Talaud
Puncak Sorik Marapi	Mandailing Natal
Puncu	Kediri
Pundong	Bantul
Punduh Pidada	Pesawaran
Punggelan	Banjarnegara
Pungging	Mojokerto
Punggur	Lampung Tengah
Punung	Pacitan
Pupuan	Tabanan
Purabaya	Sukabumi
Purba	Simalungun
Purba Tua (Purbatua)	Tapanuli Utara
Purbalingga	Purbalingga
Purbaratu	Tasikmalaya
Purbolinggo	Lampung Timur
Pureman	Alor
Puri	Mojokerto
Puriala	Konawe
Puring	Kebumen
Puring Kencana	Kapuas Hulu
Purwadadi	Ciamis
Purwadadi	Subang
Purwaharja	Banjar
Purwakarta	Cilegon
Purwakarta	Purwakarta
Purwanegara (Purwonegoro)	Banjarnegara
Purwantoro	Wonogiri
Purwasari	Karawang
Purwoasri	Kediri
Purwodadi	Grobogan
Purwodadi	Purworejo
Purwodadi	Pasuruan
Purwodadi	Musi Rawas
Purwoharjo	Banyuwangi
Purwojati	Banyumas
Purwokerto Barat	Banyumas
Purwokerto Selatan	Banyumas
Purwokerto Timur	Banyumas
Purwokerto Utara	Banyumas
Purworeja Klampok (Purworejo Klampok)	Banjarnegara
Purworejo	Purworejo
Purworejo	Pasuruan
Purwosari	Pasuruan
Purwosari	Gunung Kidul
Purwosari	Bojonegoro
Pusakajaya	Subang
Pusakanagara	Subang
Pusako	Siak
Pusomaen	Minahasa Tenggara
Puspahiang	Tasikmalaya
Puspo	Pasuruan
Puteri Betung (Putri Betung)	Gayo Lues
Putra Rumbia	Lampung Tengah
Putri Hijau	Bengkulu Utara
Putussibau Selatan	Kapuas Hulu
Putussibau Utara	Kapuas Hulu
Puuwatu	Kendari
Raas (Ra'as)	Sumenep
Raba	Bima
Rahong Utara	Manggarai
Rahunig (Rahuning)	Asahan
Raihat	Belu
Raijua	Sabu Raijua
Raimanuk	Belu
Raimbawi	Kepulauan Yapen
Rainis	Kepulauan Talaud
Raja Basa (Rajabasa)	Lampung Selatan
Rajabasa	Bandar Lampung
Rajadesa	Ciamis
Rajagaluh	Majalengka
Rajapolah	Tasikmalaya
Rajeg	Tangerang
Rakit	Banjarnegara
Rakit Kulim	Indragiri Hulu
Rakumpit	Palangka Raya
Raman Utara	Lampung Timur
Rambah	Rokan Hulu
Rambah Hilir	Rokan Hulu
Rambah Samo	Rokan Hulu
Rambang	Muara Enim
Rambang Kapak Tengah	Prabumulih
Rambang Kuang	Ogan Ilir
Rambang Niru (Rambang Dangku)	Muara Enim
Rambatan	Tanah Datar
Rambipuji	Jember
Rambutan	Banyuasin
Rambutan	Tebing Tinggi
Rampi	Luwu Utara
Rana Mese	Manggarai Timur
Ranah Ampek Hulu Tapan	Pesisir Selatan
Ranah Batahan	Pasaman Barat
Ranah Pesisir	Pesisir Selatan
Ranca Bungur	Bogor
Rancabali (Ranca Bali)	Bandung
Rancaekek	Bandung
Rancah	Ciamis
Rancakalong	Sumedang
Rancasari	Bandung
Randangan	Pohuwato
Randuagung	Lumajang
Randublatung	Blora
Randudongkal	Pemalang
Rangkasbitung	Lebak
Rangkui	Pangkal Pinang
Rangsang	Kepulauan Meranti
Rangsang Barat	Kepulauan Meranti
Rangsang Pesisir	Kepulauan Meranti
Rano	Tana Toraja
Ranomeeto	Konawe Selatan
Ranomeeto Barat	Konawe Selatan
Ranowulu (Bitung Utara)	Bitung
Ranoyapo	Minahasa Selatan
Ransiki	Manokwari Selatan
Rantau	Aceh Tamiang
Rantau Alai	Ogan Ilir
Rantau Badauh	Barito Kuala
Rantau Bayur	Banyuasin
Rantau Kopar	Rokan Hilir
Rantau Pandan	Bungo
Rantau Panjang	Ogan Ilir
Rantau Peureulak (Ranto Peureulak)	Aceh Timur
Rantau Pulung	Kutai Timur
Rantau Rasau	Tanjung Jabung Timur
Rantau Selamat	Aceh Timur
Rantau Selatan	Labuhanbatu
Rantau Utara	Labuhanbatu
Rante Angin	Kolaka Utara
Rantebua	Toraja Utara
Rantebulahan Timur	Mamasa
Rantepao	Toraja Utara
Rantetayo	Tana Toraja
Ranto Baek	Mandailing Natal
Ranuyoso	Lumajang
Rao	Pasaman
Rao Selatan	Pasaman
Rao Utara	Pasaman
Rappocini	Makassar
Raren Batuah	Barito Timur
Rarowatu	Bombana
Rarowatu Utara	Bombana
Rasanae Barat	Bima
Rasanae Timur	Bima
Rasau Jaya	Kubu Raya
Rasiei	Teluk Wondama
Ratahan	Minahasa Tenggara
Ratahan Timur	Minahasa Tenggara
Ratatotok	Minahasa Tenggara
Ratolindo	Tojo Una-Una
Ratu Agung	Bengkulu
Ratu Samban	Bengkulu
Raveni Rara (Ravenirara)	Jayapura
Rawa Jitu Selatan (Rawajitu Selatan)	Tulang Bawang
Rawa Jitu Timur (Rawajitu Timur)	Tulang Bawang
Rawa Jitu Utara	Mesuji
Rawa Pitu	Tulang Bawang
Rawalo	Banyumas
Rawalumbu	Bekasi
Rawamerta	Karawang
Rawang Panca Arga	Asahan
Rawas Ilir	Musi Rawas Utara
Rawas Ulu	Musi Rawas Utara
Raya	Simalungun
Raya Kahean	Simalungun
Reban	Batang
Rebang Tangkas	Way Kanan
Regol	Bandung
Rejoso	Nganjuk
Rejoso	Pasuruan
Rejotangan	Tulungagung
Rembang	Pasuruan
Rembang	Purbalingga
Rembang	Rembang
Remboken	Minahasa
Rembon	Tana Toraja
Renah Mendaluh	Tanjung Jabung Barat
Renah Pamenang (Renah Pemenang)	Merangin
Renah Pembarap	Merangin
Rendang	Karangasem
Rengasdengklok	Karawang
Rengat	Indragiri Hulu
Rengat Barat	Indragiri Hulu
Rengel	Tuban
Reok	Manggarai
Reok Barat	Manggarai
Reteh	Indragiri Hilir
Rhee	Sumbawa
Riau Silip	Bangka
Rikit Gaib	Gayo Lues
Rilauale (Rilau Ale)	Bulukumba
Rimba Melintang	Rokan Hilir
Rimbo Bujang	Tebo
Rimbo Ilir	Tebo
Rimbo Pengadang	Lebong
Rimbo Tengah	Bungo
Rimbo Ulu	Tebo
Rindi	Sumba Timur
Rindingallo	Toraja Utara
Ringinarum	Kendal
Ringinrejo	Kediri
Rinhat	Malaka
Rio Pakava	Donggala
Risei Sayati	Waropen
Riung	Ngada
Riung Barat	Ngada
Robatal	Sampang
Rogojampi	Banyuwangi
Rokan IV Koto	Rokan Hulu
Rongga	Bandung Barat
Ronggur Nihuta	Samosir
Rongkop	Gunung Kidul
Roon	Teluk Wondama
Ropang	Sumbawa
Roswar	Teluk Wondama
Rote Barat	Rote Ndao
Rote Barat Daya	Rote Ndao
Rote Barat Laut	Rote Ndao
Rote Selatan	Rote Ndao
Rote Tengah	Rote Ndao
Rote Timur	Rote Ndao
Routa	Konawe
Rowokangkung	Lumajang
Rowokele	Kebumen
Rowosari	Kendal
Rubaru	Sumenep
Rufaer	Mamberamo Raya
Rumbai	Pekanbaru
Rumbai Pesisir	Pekanbaru
Rumberpon	Teluk Wondama
Rumbia	Jeneponto
Rumbia	Bombana
Rumbia	Lampung Tengah
Rumbia Tengah	Bombana
Rumbio Jaya	Kampar
Rumpin	Bogor
Rundeng	Subulussalam
Rungan	Gunung Mas
Rungan Barat	Gunung Mas
Rungan Hulu	Gunung Mas
Rungkut	Surabaya
Runjung Agung	Ogan Komering Ulu Selatan
Rupat	Bengkalis
Rupat Utara	Bengkalis
Rupit	Musi Rawas Utara
Rusip Antara	Aceh Tengah
Ruteng	Manggarai
Sa'dan	Toraja Utara
Sabak Auh	Siak
Sabangau (Sebangau)	Palangka Raya
Sabangparu	Wajo
Sabbang	Luwu Utara
Sabbang Selatan	Luwu Utara
Sabu Barat	Sabu Raijua
Sabu Liae	Sabu Raijua
Sabu Tengah	Sabu Raijua
Sabu Timur	Sabu Raijua
Sabulakoa	Konawe Selatan
Sadananya	Ciamis
Sadang	Kebumen
Sadaniang	Mempawah
Sadu	Tanjung Jabung Timur
Saengkeduk	Sorong
Safan	Asmat
Sagalaherang	Subang
Sagaranten	Sukabumi
Saguling	Bandung Barat
Sagulung	Batam
Sahu	Halmahera Barat
Sahu Timur	Halmahera Barat
Saifi	Sorong Selatan
Sail	Pekanbaru
Saipar Dolok Hole	Tapanuli Selatan
Sajad	Sambas
Sajingan Besar	Sambas
Sajira	Lebak
Sajoanging	Wajo
Saketi	Pandeglang
Sako	Palembang
Sakra	Lombok Timur
Sakra Barat	Lombok Timur
Sakra Timur	Lombok Timur
Sakti	Pidie
Salahutu	Maluku Tengah
Salak	Pakpak Bharat
Salam	Magelang
Salam Babaris	Tapin
Salamadeg Timur (Salemadeg Timur)	Tabanan
Salaman	Magelang
Salang	Simeulue
Salapian	Langkat
Salatiga	Sambas
Salawati	Sorong
Salawati Barat	Raja Ampat
Salawati Selatan	Sorong
Salawati Tengah	Raja Ampat
Salawati Tengah	Sorong
Salawati Utara	Raja Ampat
Salawu	Tasikmalaya
Sale	Rembang
Salem	Brebes
Salemadeg Barat	Tabanan
Salibabu	Kepulauan Talaud
Salimpauang (Salimpaung)	Tanah Datar
Saling	Empat Lawang
Salkma	Sorong Selatan
Salo	Kampar
Salomekko	Bone
Salopa	Tasikmalaya
Saluputi (Saluputti)	Tana Toraja
Samadua (Sama Dua)	Aceh Selatan
Samalanga	Bireuen
Samalantan	Bengkayang
Samarang	Garut
Samarinda Ilir	Samarinda
Samarinda Kota	Samarinda
Samarinda Seberang	Samarinda
Samarinda Ulu	Samarinda
Samarinda Utara	Samarinda
Samatiga	Aceh Barat
Samaturu	Kolaka
Sambalia (Sambelia)	Lombok Timur
Sambaliung	Berau
Sambas	Sambas
Sambeng	Lamongan
Sambi	Boyolali
Sambi Rampas	Manggarai Timur
Sambikerep	Surabaya
Sambirejo	Sragen
Sambit	Ponorogo
Samboja (Semboja)	Kutai Kartanegara
Sambong	Blora
Sambung Makmur	Banjar
Sambungmacan (Sambung Macan)	Sragen
Sambutan	Samarinda
Samenage	Yahukimo
Samigaluh	Kulon Progo
Samofa	Biak Numfor
Sampaga	Mamuju
Sampanahan	Kotabaru
Sampang	Sampang
Sampang	Cilacap
Sampara	Konawe
Sampoiniet	Aceh Jaya
Sampolawa	Buton Selatan
Sampung	Ponorogo
Samudera	Aceh Utara
Sanaman Mantikei (Senamang Mantikei)	Katingan
Sanana	Kepulauan Sula
Sanana Utara	Kepulauan Sula
Sanankulon (Sanan Kulon)	Blitar
Sananwetan (Sanan Wetan)	Blitar
Sandai	Ketapang
Sandaran	Kutai Timur
Sanden	Bantul
Sandubaya (Sandujaya)	Mataram
Sang Tombolang	Bolaang Mongondow
Sanga Desa	Musi Banyuasin
Sanga-Sanga	Kutai Kartanegara
Sangalla (Sanggala)	Tana Toraja
Sangalla Selatan	Tana Toraja
Sangalla Utara	Tana Toraja
Sangatta Selatan	Kutai Timur
Sangatta Utara	Kutai Timur
Sanggalangi	Toraja Utara
Sanggar	Bima
Sanggau Ledo	Bengkayang
Sangia Wambulu	Buton Tengah
Sangir	Solok Selatan
Sangir Balai Janggo	Solok Selatan
Sangir Batang Hari	Solok Selatan
Sangir Jujuan	Solok Selatan
Sangkapura	Gresik
Sangkub	Bolaang Mongondow Utara
Sangkulirang	Kutai Timur
Sano Nggoang	Manggarai Barat
Sanrobone	Takalar
Santian	Timor Tengah Selatan
Saparua	Maluku Tengah
Saparua Timur	Maluku Tengah
Sape	Bima
Sapeken	Sumenep
Saptosari (Sapto Sari)	Gunung Kidul
Sapuran	Wonosobo
Saradan	Madiun
Sarang	Rembang
Sario	Manado
Sarirejo	Lamongan
Sariwangi	Tasikmalaya
Sarjo	Pasangkayu (Mamuju Utara)
Sarmi	Sarmi
Sarmi Selatan	Sarmi
Sarmi Timur	Sarmi
Sarolangun	Sarolangun
Saronggi	Sumenep
Sarudik	Tapanuli Tengah
Sarudu	Pasangkayu (Mamuju Utara)
Sasak Ranah Pesisir / Pasisir / Pesisie	Pasaman Barat
Sasitamean	Malaka
Satar Mese	Manggarai
Satar Mese Barat	Manggarai
Satar Mese Utara	Manggarai
Sateluk (Seteluk)	Sumbawa Barat
Satui	Tanah Bumbu
Sausapor	Tambrauw
Sausu	Parigi Moutong
Sawa	Konawe Utara
Sawa Erma	Asmat
Sawah Besar	Jakarta Pusat
Sawahan	Madiun
Sawahan	Nganjuk
Sawahan	Surabaya
Sawai	Mamberamo Raya
Sawan	Buleleng
Sawang	Aceh Selatan
Sawang	Aceh Utara
Sawangan	Depok
Sawangan	Magelang
Sawerigadi	Muna Barat
Sawiat	Sorong Selatan
Sawit	Boyolali
Sawit Seberang	Langkat
Sawo	Nias Utara
Sawoo	Ponorogo
Sayan	Melawi
Sayosa	Sorong
Sayosa Timur	Sorong
Sayung	Demak
Sayur Matinggi	Tapanuli Selatan
Sebangau Kuala	Pulang Pisau
Sebangki	Landak
Sebatik	Nunukan
Sebatik Barat	Nunukan
Sebatik Tengah	Nunukan
Sebatik Timur	Nunukan
Sebatik Utara	Nunukan
Sebawi	Sambas
Seberang Kota	Tanjung Jabung Barat
Seberang Musi	Kepahiang
Seberang Ulu I	Palembang
Seberang Ulu II	Palembang
Seberuang	Kapuas Hulu
Sebuku	Nunukan
Sebulu	Kutai Kartanegara
Secang	Magelang
Secanggang	Langkat
Sedan	Rembang
Sedati	Sidoarjo
Sedayu	Bantul
Sedong	Cirebon
Segah	Berau
Segedong	Mempawah
Segeri	Pangkajene Kepulauan
Seget	Sorong
Seginim	Bengkulu Selatan
Segun	Sorong
Sei Balai	Batu Bara
Sei Bamban	Serdang Bedagai
Sei Bingei (Sei Binge / Bingai)	Langkat
Sei Dadap	Asahan
Sei Kepayang	Asahan
Sei Kepayang Barat	Asahan
Sei Kepayang Timur	Asahan
Sei Lepan	Langkat
Sei Menggaris	Nunukan
Sei Rampah	Serdang Bedagai
Sei Suka	Batu Bara
Sei Tualang Raso	Tanjung Balai
Sei/Sungai Beduk	Batam
Sei/Sungai Kanan	Labuhanbatu Selatan
Sei/Sungai Kunyit	Mempawah
Sei/Sungai Pinang	Banjar
Sei/Sungai Pinyuh	Mempawah
Sei/Sungai Tabuk	Banjar
Sejangkung	Sambas
Sekadau Hilir	Sekadau
Sekadau Hulu	Sekadau
Sekampung	Lampung Timur
Sekampung Udik	Lampung Timur
Sekar	Bojonegoro
Sekaran	Lamongan
Sekarbela	Mataram
Sekatak	Bulungan
Sekayam	Sanggau
Sekayu	Musi Banyuasin
Sekerak	Aceh Tamiang
Sekernan	Muaro Jambi
Sekincau	Lampung Barat
Seko	Luwu Utara
Sekolaq Darat	Kutai Barat
Sekongkang	Sumbawa Barat
Sekotong	Lombok Barat
Sekupang	Batam
Sela	Yahukimo
Selaawi	Garut
Selagai Lingga	Lampung Tengah
Selagan Raya	Muko Muko
Selajambe	Kuningan
Selakau	Sambas
Selakau Timur	Sambas
Selangit	Musi Rawas
Selaparang (Selaprang)	Mataram
Selaru	Kepulauan Tanimbar (Maluku Tenggara Barat)
Selat	Kapuas
Selat	Karangasem
Selat Nasik	Belitung
Selat Penuguan	Banyuasin
Selayar	Lingga
Selebar	Bengkulu
Selemadeg	Tabanan
Selemkai	Tambrauw
Selesai	Langkat
Selimbau	Kapuas Hulu
Selo	Boyolali
Selogiri	Wonogiri
Selomerto	Wonosobo
Selong	Lombok Timur
Selopampang	Temanggung
Selopuro	Blitar
Selorejo	Blitar
Seluas	Bengkayang
Seluma	Seluma
Seluma Barat	Seluma
Seluma Selatan	Seluma
Seluma Timur	Seluma
Seluma Utara	Seluma
Selupu Rejang	Rejang Lebong
Semadam	Aceh Tenggara
Semaka	Tanggamus
Semampir	Surabaya
Semanding	Tuban
Semangga	Merauke
Semanu	Gunung Kidul
Semarang Barat	Semarang
Semarang Selatan	Semarang
Semarang Tengah	Semarang
Semarang Timur	Semarang
Semarang Utara	Semarang
Sematang Borang	Palembang
Sematu Jaya	Lamandau
Semau	Kupang
Semau Selatan	Kupang
Sembakung	Nunukan
Sembakung Atulai	Nunukan
Sembalun	Lombok Timur
Sembawa	Banyuasin
Sembilan Koto	Dharmasraya
Semboro	Jember
Semen	Kediri
Semendawai Barat	Ogan Komering Ulu Timur
Semendawai Suku III	Ogan Komering Ulu Timur
Semendawai Timur	Ogan Komering Ulu Timur
Semende Darat Laut	Muara Enim
Semende Darat Tengah	Muara Enim
Semende Darat Ulu	Muara Enim
Semidang Aji	Ogan Komering Ulu
Semidang Alas	Seluma
Semidang Alas Maras	Seluma
Semidang Gumai (Gumay)	Kaur
Semidang Lagan	Bengkulu Tengah
Semin	Gunung Kidul
Semitau	Kapuas Hulu
Semparuk	Sambas
Sempol	Bondowoso
Sempor	Kebumen
Sempu	Banyuwangi
Senapelan	Pekanbaru
Senayang	Lingga
Sendana	Majene
Sendana	Palopo
Sendang	Tulungagung
Sendang Agung	Lampung Tengah
Senduro	Lumajang
Senen	Jakarta Pusat
Sengah Temila	Landak
Senggi	Keerom
Senopi	Tambrauw
Senori	Tuban
Sentajo Raya	Kuantan Singingi
Sentani	Jayapura
Sentani Barat	Jayapura
Sentani Timur	Jayapura
Sentolo	Kulon Progo
Senyerang	Tanjung Jabung Barat
Sepaku	Penajam Paser Utara
Sepang (Sepang Simin)	Gunung Mas
Sepatan	Tangerang
Sepatan Timur	Tangerang
Sepauk	Sintang
Seponti	Kayong Utara
Sepulu	Bangkalan
Sepuluh Koto (X Koto)	Tanah Datar
Seputih Agung	Lampung Tengah
Seputih Banyak	Lampung Tengah
Seputih Mataram	Lampung Tengah
Seputih Raman	Lampung Tengah
Seputih Surabaya	Lampung Tengah
Serai Serumpun	Tebo
Seram Barat	Seram Bagian Barat
Seram Timur	Seram Bagian Timur
Seram Utara	Maluku Tengah
Seram Utara Barat	Maluku Tengah
Seram Utara Timur Kobi	Maluku Tengah
Seram Utara Timur Seti	Maluku Tengah
Serambakon	Pegunungan Bintang
Seranau	Kotawaringin Timur
Serang	Serang
Serang Baru	Bekasi
Serangpanjang	Subang
Serasan	Natuna
Serasan Timur	Natuna
Serawai	Sintang
Serba Jadi	Serdang Bedagai
Serbajadi	Aceh Timur
Seredela (Seredala)	Yahukimo
Seremuk	Sorong Selatan
Serengan	Surakarta
Seri/Sri Kuala Lobam	Bintan
Seribu Riam	Murung Raya
Seririt	Buleleng
Serpong	Tangerang Selatan
Serpong Utara	Tangerang Selatan
Seruway	Aceh Tamiang
Seruyan Hilir	Seruyan
Seruyan Hilir Timur	Seruyan
Seruyan Hulu	Seruyan
Seruyan Raya	Seruyan
Seruyan Tengah	Seruyan
Sesayap	Tana Tidung
Sesayap Hilir	Tana Tidung
Sesean	Toraja Utara
Sesean Suloara	Toraja Utara
Sesenapadang	Mamasa
Sesnuk	Boven Digoel
Setia	Aceh Barat Daya
Setia Bhakti (Setia Bakti)	Aceh Jaya
Setia Janji	Asahan
Setiabudi (Setia Budi)	Jakarta Selatan
Setu	Tangerang Selatan
Setu	Bekasi
Seulimeum	Aceh Besar
Seunagan	Nagan Raya
Seunagan Timur	Nagan Raya
Seunuddon (Seunudon)	Aceh Utara
Sewon	Bantul
Seyegan	Sleman
Siabu	Mandailing Natal
Siak	Siak
Siak Hulu	Kampar
Siak Kecil	Bengkalis
Sianjur / Sianjar Mula Mula	Samosir
Siantan	Mempawah
Siantan	Kepulauan Anambas
Siantan Selatan	Kepulauan Anambas
Siantan Tengah	Kepulauan Anambas
Siantan Timur	Kepulauan Anambas
Siantan Utara	Kepulauan Anambas
Siantar	Simalungun
Siantar Barat	Pematang Siantar
Siantar Marihat	Pematang Siantar
Siantar Marimbun	Pematang Siantar
Siantar Martoba	Pematang Siantar
Siantar Narumonda	Toba Samosir
Siantar Selatan	Pematang Siantar
Siantar Sitalasari	Pematang Siantar
Siantar Timur	Pematang Siantar
Siantar Utara	Pematang Siantar
Siatas Barita	Tapanuli Utara
Siau Barat	Kepulauan Siau Tagulandang Biaro (Sitaro)
Siau Barat Selatan	Kepulauan Siau Tagulandang Biaro (Sitaro)
Siau Barat Utara	Kepulauan Siau Tagulandang Biaro (Sitaro)
Siau Tengah	Kepulauan Siau Tagulandang Biaro (Sitaro)
Siau Timur	Kepulauan Siau Tagulandang Biaro (Sitaro)
Siau Timur Selatan	Kepulauan Siau Tagulandang Biaro (Sitaro)
Sibabangun	Tapanuli Tengah
Siberida (Seberida)	Indragiri Hulu
Siberut Barat	Kepulauan Mentawai
Siberut Barat Daya	Kepulauan Mentawai
Siberut Selatan	Kepulauan Mentawai
Siberut Tengah	Kepulauan Mentawai
Siberut Utara	Kepulauan Mentawai
Sibiru-biru (Biru-Biru)	Deli Serdang
Sibolangit	Deli Serdang
Sibolga Kota	Sibolga
Sibolga Sambas	Sibolga
Sibolga Selatan	Sibolga
Sibolga Utara	Sibolga
Siborong-Borong	Tapanuli Utara
Sibulue	Bone
Sidamanik	Simalungun
Sidamulih	Pangandaran
Sidareja	Cilacap
Sidayu	Gresik
Sidemen	Karangasem
Sidey	Manokwari
Sidikalang	Dairi
Siding	Bengkayang
Sidoan	Parigi Moutong
Sidoarjo	Sidoarjo
Sidoharjo	Sragen
Sidoharjo	Wonogiri
Sidomukti	Salatiga
Sidomulyo	Lampung Selatan
Sidorejo	Magetan
Sidorejo	Salatiga
Sidua'ori	Nias Selatan
Siempat Nempu	Dairi
Siempat Nempu Hilir	Dairi
Siempat Nempu Hulu	Dairi
Siempat Rube	Pakpak Bharat
Siepkosi	Jayawijaya
Sigaluh	Banjarnegara
Sigi Biromaru	Sigi
Sigumpar	Toba Samosir
Sihapas Barumun	Padang Lawas
Sijamapolang (Sijama Polang)	Humbang Hasundutan
Sijuk	Belitung
Sijunjung	Sijunjung
Sikakap	Kepulauan Mentawai
Sikap Dalam	Empat Lawang
Sikur	Lombok Timur
Silaen	Toba Samosir
Silahisabungan (Silahi Sabungan)	Dairi
Silangkitang	Labuhanbatu Selatan
Silat Hilir	Kapuas Hulu
Silat Hulu	Kapuas Hulu
Silau Laut	Asahan
Silaut	Pesisir Selatan
Silian Raya	Minahasa Tenggara
Silih Nara	Aceh Tengah
Silima Pungga Pungga	Dairi
Silimakuta	Simalungun
Silimo	Yahukimo
Silinda	Serdang Bedagai
Siliragung	Banyuwangi
Silo	Jember
Silo Karno Doga	Jayawijaya
Silou Kahean	Simalungun
Silungkang	Sawah Lunto
Siluq Ngurai	Kutai Barat
Siman	Ponorogo
Simangambat	Padang Lawas Utara
Simangumban	Tapanuli Utara
Simanindo	Samosir
Simbang	Maros
Simboro dan Kepulauan	Mamuju
Simbuang	Tana Toraja
Simeulue Barat (Simeuleu Barat)	Simeulue
Simeulue Cut	Simeulue
Simeulue Tengah (Simeuleu Tengah)	Simeulue
Simeulue Timur (Simeuleu Timur)	Simeulue
Simo	Boyolali
Simokerto	Surabaya
Simpang	Ogan Komering Ulu Selatan
Simpang Alahan Mati	Pasaman
Simpang Dua	Ketapang
Simpang Empat	Banjar
Simpang Empat	Tanah Bumbu
Simpang Empat	Asahan
Simpang Empat	Karo
Simpang Hilir	Kayong Utara
Simpang Hulu	Ketapang
Simpang Jernih	Aceh Timur
Simpang Kanan	Aceh Singkil
Simpang Kanan	Rokan Hilir
Simpang Katis	Bangka Tengah
Simpang Kiri	Subulussalam
Simpang Kramat (Keramat)	Aceh Utara
Simpang Mamplam	Bireuen
Simpang Pematang	Mesuji
Simpang Pesak	Belitung Timur
Simpang Raya	Banggai
Simpang Renggiang	Belitung Timur
Simpang Rimba	Bangka Selatan
Simpang Teritip	Bangka Barat
Simpang Tiga	Aceh Besar
Simpang Tiga	Pidie
Simpang Ulim	Aceh Timur
Simpenan	Sukabumi
Simpur	Hulu Sungai Selatan
Simuk	Nias Selatan
Sinaboi (Senaboi)	Rokan Hilir
Sinak	Puncak
Sinak Barat	Puncak
Sinar Peninjauan	Ogan Komering Ulu
Sindang	Indramayu
Sindang	Majalengka
Sindang Agung (Sindangagung)	Kuningan
Sindang Beliti Ilir	Rejang Lebong
Sindang Beliti Ulu	Rejang Lebong
Sindang Danau	Ogan Komering Ulu Selatan
Sindang Dataran (Sindang Daratan)	Rejang Lebong
Sindang Jaya	Tangerang
Sindang Kelingi	Rejang Lebong
Sindangbarang	Cianjur
Sindangkasih	Ciamis
Sindangkerta	Bandung Barat
Sindangresmi	Pandeglang
Sindangwangi	Majalengka
Sindue	Donggala
Sindue Tobata	Donggala
Sindue Tombusabora	Donggala
Sine	Ngawi
Sinembah Tanjung Muda Hilir	Deli Serdang
Sinembah Tanjung Muda Hulu	Deli Serdang
Singajaya	Garut
Singaparna	Tasikmalaya
Singaran Pati	Bengkulu
Singgahan	Tuban
Singingi	Kuantan Singingi
Singingi Hilir	Kuantan Singingi
Singkawang Barat	Singkawang
Singkawang Selatan	Singkawang
Singkawang Tengah	Singkawang
Singkawang Timur	Singkawang
Singkawang Utara	Singkawang
Singkep	Lingga
Singkep Barat	Lingga
Singkep Pesisir	Lingga
Singkep Selatan	Lingga
Singkil	Manado
Singkil	Aceh Singkil
Singkil Utara	Aceh Singkil
Singkohor	Aceh Singkil
Singkup	Ketapang
Singkut	Sarolangun
Singojuruh	Banyuwangi
Singorojo	Kendal
Singosari	Malang
Siniu	Parigi Moutong
Sinjai Barat	Sinjai
Sinjai Borong	Sinjai
Sinjai Selatan	Sinjai
Sinjai Tengah	Sinjai
Sinjai Timur	Sinjai
Sinjai Utara	Sinjai
Sinoa	Bantaeng
Sinonsayang	Minahasa Selatan
Sintang	Sintang
Sintuak Toboh Gadang	Padang Pariaman
Sinunukan	Mandailing Natal
Siompu	Buton Selatan
Siompu Barat	Buton Selatan
Siotapina (Siontapia / Siontapina)	Buton
Sipahutar	Tapanuli Utara
Sipatana	Gorontalo
Sipirok	Tapanuli Selatan
Sipispis	Serdang Bedagai
Sipoholon	Tapanuli Utara
Sipora Selatan	Kepulauan Mentawai
Sipora Utara	Kepulauan Mentawai
Sir-Sir	Kepulauan Aru
Sirah Pulau Padang	Ogan Komering Ilir
Sirampog	Brebes
Sirandorung	Tapanuli Tengah
Sirapit (Serapit)	Langkat
Sirenja	Donggala
Sirets	Asmat
Sirimau	Ambon
Siritaun Wida Timur	Seram Bagian Timur
Siriwo	Nabire
Siriwo	Paniai
Sirombu	Nias Barat
Sitahuis	Tapanuli Tengah
Sitellu / Sitelu Tali Urang Jehe	Pakpak Bharat
Sitellu / Sitelu Tali Urang Julu	Pakpak Bharat
Sitinjau Laut	Kerinci
Sitinjo	Dairi
Sitio-tio	Samosir
Sitiung	Dharmasraya
Sitolu Ori	Nias Utara
Situbondo	Situbondo
Situjuah Limo/Lima Nagari	Lima Puluh Kota
Situraja	Sumedang
Siulak	Kerinci
Siulak Mukai	Kerinci
Siwalalat	Seram Bagian Timur
Siwalan	Pekalongan
Skanto	Keerom
Slahung	Ponorogo
Slawi	Tegal
Sleman	Sleman
Sliyeg	Indramayu
Slogohimo	Wonogiri
Sluke	Rembang
Soa	Ngada
Soba	Yahukimo
Sobaham	Yahukimo
Sobang	Lebak
Sobang	Pandeglang
Socah	Bangkalan
Sodonghilir	Tasikmalaya
Sogae'adu (Sogae Adu / Sogaeadu)	Nias
Sojol	Donggala
Sojol Utara	Donggala
Sokan	Melawi
Sokaraja	Banyumas
Soko	Tuban
Sokobanah	Sampang
Solear	Tangerang
Soloikma	Yahukimo
Solokanjeruk (Solokan Jeruk)	Bandung
Solokuro	Lamongan
Solor Barat	Flores Timur
Solor Selatan	Flores Timur
Solor Timur	Flores Timur
Somagede	Banyumas
Somambawa	Nias Selatan
Somba Opu (Upu)	Gowa
Somolo-Molo (Samolo)	Nias
Sompak	Landak
Sonder	Minahasa
Songgom	Brebes
Songgon	Banyuwangi
Sooko	Mojokerto
Sooko	Ponorogo
Sopai	Toraja Utara
Soppeng Riaja	Barru
Sorawolio (Sora Walio / Sorowalio)	Bau-Bau
Soreang	Parepare
Soreang	Bandung
Sorkam	Tapanuli Tengah
Sorkam Barat	Tapanuli Tengah
Soromandi	Bima
Sorong	Sorong
Sorong	Sorong
Sorong Barat	Sorong
Sorong Kepulauan	Sorong
Sorong Kota	Sorong
Sorong Manoi	Sorong
Sorong Timur	Sorong
Sorong Utara	Sorong
Soropia	Konawe
Sosa	Padang Lawas
Sosoh Buay Rayap	Ogan Komering Ulu
Sosopan	Padang Lawas
Sosorgadong (Sosor Gadong)	Tapanuli Tengah
Sota	Merauke
Soug Jaya	Teluk Wondama
Soyo Jaya	Morowali Utara
Soyoi Mambai	Waropen
Sragen	Sragen
Sragi	Pekalongan
Sragi	Lampung Selatan
Srandakan	Bantul
Srengat	Blitar
Sreseh	Sampang
Srono	Banyuwangi
Srumbung	Magelang
Sruweng	Kebumen
Stabat	Langkat
Suak Midai	Natuna
Suak Tapeh	Banyuasin
Suator	Asmat
Subah	Sambas
Subah	Batang
Subang	Kuningan
Subang	Subang
Subi	Natuna
Suboh	Situbondo
Subur	Boven Digoel
Sucinaraja	Garut
Sudimoro	Pacitan
Suela (Suwela)	Lombok Timur
Sugapa	Intan Jaya
Sugihwaras	Bojonegoro
Sugio	Lamongan
Suhaid	Kapuas Hulu
Suka Bangun	Tapanuli Tengah
Suka Karya (Sukakarya)	Musi Rawas
Suka Makmue	Nagan Raya
Sukabumi	Bandar Lampung
Sukabumi	Sukabumi
Sukadana	Ciamis
Sukadana	Kayong Utara
Sukadana	Lampung Timur
Sukadiri	Tangerang
Sukagumiwang	Indramayu
Sukahaji	Majalengka
Sukahening	Tasikmalaya
Sukajadi	Bandung
Sukajadi	Pekanbaru
Sukajaya	Bogor
Sukajaya	Sabang
Sukakarya	Sabang
Sukakarya	Bekasi
Sukalarang	Sukabumi
Sukaluyu	Cianjur
Sukamaju	Luwu Utara
Sukamaju Selatan	Luwu Utara
Sukamakmur	Bogor
Sukamakmur (Suka Makmur)	Aceh Besar
Sukamantri	Ciamis
Sukamara	Sukamara
Sukamerindu	Lahat
Sukamulia	Lombok Timur
Sukamulya	Tangerang
Sukanagara	Cianjur
Sukapura	Probolinggo
Sukaraja	Seluma
Sukaraja	Bogor
Sukaraja	Sukabumi
Sukaraja	Tasikmalaya
Sukarame	Tasikmalaya
Sukarame	Bandar Lampung
Sukarami	Palembang
Sukaratu	Tasikmalaya
Sukaresik	Tasikmalaya
Sukaresmi	Pandeglang
Sukaresmi	Cianjur
Sukaresmi	Garut
Sukasada	Buleleng
Sukasari	Bandung
Sukasari	Purwakarta
Sukasari	Subang
Sukasari	Sumedang
Sukatani	Bekasi
Sukatani	Purwakarta
Sukau	Lampung Barat
Sukawangi	Bekasi
Sukawati	Gianyar
Sukawening	Garut
Sukikai Selatan	Dogiyai
Sukmajaya	Depok
Sukodadi	Lamongan
Sukodono	Lumajang
Sukodono	Sidoarjo
Sukodono	Sragen
Sukoharjo	Sukoharjo
Sukoharjo	Wonosobo
Sukoharjo	Pringsewu
Sukolilo	Surabaya
Sukolilo	Pati
Sukomanunggal	Surabaya
Sukomoro	Magetan
Sukomoro	Nganjuk
Sukorambi	Jember
Sukorame	Lamongan
Sukorejo	Pasuruan
Sukorejo	Ponorogo
Sukorejo	Kendal
Sukorejo	Blitar
Sukosari	Bondowoso
Sukosewu	Bojonegoro
Sukowono	Jember
Sukra	Indramayu
Suku Tengah Lakitan Ulu Terawas	Musi Rawas
Sukun	Malang
Sulabesi Barat	Kepulauan Sula
Sulabesi Selatan	Kepulauan Sula
Sulabesi Tengah	Kepulauan Sula
Sulabesi Timur	Kepulauan Sula
Sulamu	Kupang
Sulang	Rembang
Suli	Luwu
Suli Barat	Luwu
Suliki	Lima Puluh Kota
Suling Tambun	Seruyan
Sultan Daulat	Subulussalam
Suluun Tareran	Minahasa Selatan
Sumalata	Gorontalo Utara
Sumalata Timur	Gorontalo Utara
Sumarorong	Mamasa
Sumay	Tebo
Sumbang	Banyumas
Sumbawa	Sumbawa
Sumber	Probolinggo
Sumber	Cirebon
Sumber	Rembang
Sumber Barito	Murung Raya
Sumber Harta	Musi Rawas
Sumber Jaya	Lampung Barat
Sumber Marga Telang	Banyuasin
Sumber Rejo (Sumberejo)	Tanggamus
Sumberasih	Probolinggo
Sumberbaru (Sumber Baru)	Jember
Sumberejo	Bojonegoro
Sumbergempol	Tulungagung
Sumberjambe (Sumber Jambe)	Jember
Sumberjaya	Majalengka
Sumberlawang	Sragen
Sumbermalang	Situbondo
Sumbermanjing Wetan	Malang
Sumberpucung	Malang
Sumbersari (Sumber Sari)	Jember
Sumbersuko	Lumajang
Sumberwringin (Sumber Wringin)	Bondowoso
Sumbul	Dairi
Sumedang Selatan	Sumedang
Sumedang Utara	Sumedang
Sumo	Yahukimo
Sumobito	Jombang
Sumowono	Semarang
Sumpiuh	Banyumas
Sumpur Kudus	Sijunjung
Sumur	Pandeglang
Sumur Bandung	Bandung
Sumuri (Simuri)	Teluk Bintuni
Sungai Ambawang	Kubu Raya
Sungai Apit	Siak
Sungai Are	Ogan Komering Ulu Selatan
Sungai Babuat	Murung Raya
Sungai Bahar	Muaro Jambi
Sungai Batang	Indragiri Hilir
Sungai Betung	Bengkayang
Sungai Boh	Malinau
Sungai Bungkal	Sungaipenuh
Sungai Durian (Sungaidurian)	Kotabaru
Sungai Garingging	Padang Pariaman
Sungai Gelam	Muaro Jambi
Sungai Kakap	Kubu Raya
Sungai Keruh	Musi Banyuasin
Sungai Kunjang	Samarinda
Sungai Lala	Indragiri Hulu
Sungai Laur	Ketapang
Sungai Lilin	Musi Banyuasin
Sungai Limau	Padang Pariaman
Sungai Loban	Tanah Bumbu
Sungai Manau	Merangin
Sungai Mandau	Siak
Sungai Mas	Aceh Barat
Sungai Melayu Rayak	Ketapang
Sungai Menang	Ogan Komering Ilir
Sungai Pagu	Solok Selatan
Sungai Pandan	Hulu Sungai Utara
Sungai Penuh	Sungaipenuh
Sungai Pinang	Samarinda
Sungai Pinang	Ogan Ilir
Sungai Pua (Puar)	Agam
Sungai Raya	Bengkayang
Sungai Raya	Kubu Raya
Sungai Raya	Hulu Sungai Selatan
Sungai Raya	Aceh Timur
Sungai Raya Kepulauan	Bengkayang
Sungai Rotan	Muara Enim
Sungai Rumbai	Dharmasraya
Sungai Rumbai	Muko Muko
Sungai Selan	Bangka Tengah
Sungai Sembilan	Dumai
Sungai Serut	Bengkulu
Sungai Tabukan	Hulu Sungai Utara
Sungai Tarab	Tanah Datar
Sungai Tebelian	Sintang
Sungai Tubu	Malinau
Sungaiaur (Sungai Aur)	Pasaman Barat
Sungaiberemas (Sei Beremas)	Pasaman Barat
Sungailiat (Sungai Liat)	Bangka
Sungayang	Tanah Datar
Sunggal	Deli Serdang
Sungkai Barat	Lampung Utara
Sungkai Jaya	Lampung Utara
Sungkai Selatan	Lampung Utara
Sungkai Tengah	Lampung Utara
Sungkai Utara	Lampung Utara
Sunook	Sorong
Suntamon	Yahukimo
Suoh	Lampung Barat
Supiori Barat	Supiori
Supiori Selatan	Supiori
Supiori Timur	Supiori
Supiori Utara	Supiori
Supnin	Raja Ampat
Suppa	Pinrang
Suradadi (Surodadi)	Tegal
Surade	Sukabumi
Suralaga	Lombok Timur
Suranenggala	Cirebon
Surian	Sumedang
Suro Makmur	Aceh Singkil
Suru Suru	Yahukimo
Suru-suru	Asmat
Suruh	Trenggalek
Suruh	Semarang
Sururey	Pegunungan Arfak
Susoh	Aceh Barat Daya
Susua	Nias Selatan
Susukan	Cirebon
Susukan	Banjarnegara
Susukan	Semarang
Susukan Lebak	Cirebon
Susut	Bangli
Sutera	Pesisir Selatan
Suti Semarang	Bengkayang
Sutojayan	Blitar
Suwawa	Bone Bolango
Suwawa Selatan	Bone Bolango
Suwawa Tengah	Bone Bolango
Suwawa Timur	Bone Bolango
Swandiwe	Biak Numfor
Syahcame	Mappi
Syamtalira Aron	Aceh Utara
Syamtalira Bayu	Aceh Utara
Syiah Kuala	Banda Aceh
Syiah Utama	Bener Meriah
Syujak	Tambrauw
Taba Penanjung	Bengkulu Tengah
Tabalar	Berau
Tabanan	Tabanan
Tabang	Mamasa
Tabang	Kutai Kartanegara
Tabir	Merangin
Tabir Barat	Merangin
Tabir Ilir	Merangin
Tabir Lintas	Merangin
Tabir Selatan	Merangin
Tabir Timur	Merangin
Tabir Ulu	Merangin
Tabona	Pulau Taliabu
Tabongo	Gorontalo
Tabonji	Merauke
Tabukan	Barito Kuala
Tabukan Selatan	Kepulauan Sangihe
Tabukan Selatan Tengah	Kepulauan Sangihe
Tabukan Selatan Tenggara	Kepulauan Sangihe
Tabukan Tengah	Kepulauan Sangihe
Tabukan Utara	Kepulauan Sangihe
Tabulahan	Mamasa
Tabundung	Sumba Timur
Tabunganen	Barito Kuala
Tadu Raya	Nagan Raya
Taebenu	Kupang
Taelarek	Jayawijaya
Taganombak	Puncak Jaya
Tagime	Jayawijaya
Tagime	Tolikara
Tagineri	Tolikara
Tagineri	Jayawijaya
Tagulandang	Kepulauan Siau Tagulandang Biaro (Sitaro)
Tagulandang Selatan	Kepulauan Siau Tagulandang Biaro (Sitaro)
Tagulandang Utara	Kepulauan Siau Tagulandang Biaro (Sitaro)
Tahota	Manokwari Selatan
Tahuna	Kepulauan Sangihe
Tahuna Barat	Kepulauan Sangihe
Tahuna Timur	Kepulauan Sangihe
Tahunan	Jepara
Taige	Pegunungan Arfak
Tajinan	Malang
Tajurhalang	Bogor
Taka Bonerate (Takabonerate)	Kepulauan Selayar
Takari	Kupang
Takeran	Magetan
Takisung	Tanah Laut
Takkalalla	Wajo
Takokak	Cianjur
Taktakan	Serang
Talaga	Majalengka
Talaga Jaya (Telaga Jaya)	Gorontalo
Talaga Raya	Buton Tengah
Talamau	Pasaman Barat
Talambo	Yahukimo
Talang	Tegal
Talang Empat	Bengkulu Tengah
Talang Kelapa	Banyuasin
Talang Muandau	Bengkalis
Talang Padang	Empat Lawang
Talang Padang	Tanggamus
Talang Ubi	Penukal Abab Lematang Ilir
Talango	Sumenep
Talatako	Tojo Una-Una
Talawaan	Minahasa Utara
Talawi	Sawah Lunto
Talawi	Batu Bara
Talegong	Garut
Taliabu Barat	Pulau Taliabu
Taliabu Barat Laut	Pulau Taliabu
Taliabu Selatan	Pulau Taliabu
Taliabu Timur	Pulau Taliabu
Taliabu Timur Selatan	Pulau Taliabu
Taliabu Utara	Pulau Taliabu
Talibura	Sikka
Talisayan	Berau
Taliwang	Sumbawa Barat
Tallo	Makassar
Tallunglipu	Toraja Utara
Talo	Seluma
Talo Kecil	Seluma
Taluditi (Taluduti)	Pohuwato
Talun	Pekalongan
Talun	Blitar
Talun (Cirebon Selatan)	Cirebon
Tamako	Kepulauan Sangihe
Tamalanrea	Makassar
Tamalate	Makassar
Tamalatea	Jeneponto
Taman	Pemalang
Taman	Madiun
Taman	Sidoarjo
Taman Krocok	Bondowoso
Taman Rajo	Muaro Jambi
Taman Sari	Pangkal Pinang
Taman Sari	Jakarta Barat
Tamanan	Bondowoso
Tamansari	Bogor
Tamansari	Tasikmalaya
Tamansari	Boyolali
Tambak	Banyumas
Tambak	Gresik
Tambakboyo	Tuban
Tambakdahan	Subang
Tambakrejo	Bojonegoro
Tambakromo	Pati
Tambaksari	Ciamis
Tambaksari	Surabaya
Tamban	Barito Kuala
Tamban Catur	Kapuas
Tambang	Kampar
Tambang Ulang	Tanah Laut
Tambangan	Mandailing Natal
Tambelan	Bintan
Tambelang	Bekasi
Tambelangan	Sampang
Tambora	Bima
Tambora	Jakarta Barat
Tambun Selatan	Bekasi
Tambun Utara	Bekasi
Tambusai	Rokan Hulu
Tambusai Utara	Rokan Hulu
Tamiang Hulu	Aceh Tamiang
Tammerodo Sendana (Tammeredo Sendana)	Majene
Tampahan	Toba Samosir
Tampaksiring (Tampak Siring)	Gianyar
Tampan	Pekanbaru
Tampan' Amma (Tampan Amma)	Kepulauan Talaud
Tana Lia	Tana Tidung
Tana Lili	Luwu Utara
Tana Righu	Sumba Barat
Tana Wawo	Sikka
Tanah Abang	Penukal Abab Lematang Ilir
Tanah Abang	Jakarta Pusat
Tanah Grogot	Paser
Tanah Jambo Aye	Aceh Utara
Tanah Jawa	Simalungun
Tanah Kampung	Sungaipenuh
Tanah Luas	Aceh Utara
Tanah Masa	Nias Selatan
Tanah Merah	Indragiri Hilir
Tanah Merah	Bangkalan
Tanah Miring	Merauke
Tanah Pasir	Aceh Utara
Tanah Pinem	Dairi
Tanah Pinoh	Melawi
Tanah Pinoh Barat	Melawi
Tanah Putih	Rokan Hilir
Tanah Putih Tanjung Melawan	Rokan Hilir
Tanah Rubuh	Manokwari
Tanah Sareal (Tanah Sereal)	Bogor
Tanah Sepenggal	Bungo
Tanah Sepenggal Lintas	Bungo
Tanah Siang	Murung Raya
Tanah Siang Selatan	Murung Raya
Tanah Tumbuh	Bungo
Tanambulava	Sigi
Tanantovea	Donggala
Tanara	Serang
Tanasitolo	Wajo
Tandes	Surabaya
Tanduk Kalua	Mamasa
Tandun	Rokan Hulu
Tanete Riaja	Barru
Tanete Riattang	Bone
Tanete Riattang Barat	Bone
Tanete Riattang Timur	Bone
Tanete Rilau	Barru
Tangan-Tangan	Aceh Barat Daya
Tangaran	Sambas
Tangen	Sragen
Tangerang	Tangerang
Tanggetada	Kolaka
Tanggeung	Cianjur
Tanggul	Jember
Tanggulangin	Sidoarjo
Tanggunggunung (Tanggung Gunung)	Tulungagung
Tanggungharjo	Grobogan
Tangma	Yahukimo
Tangse	Pidie
Tanimbar Selatan	Kepulauan Tanimbar (Maluku Tenggara Barat)
Tanimbar Utara	Kepulauan Tanimbar (Maluku Tenggara Barat)
Taniwel	Seram Bagian Barat
Taniwel Timur	Seram Bagian Barat
Tanjuang Baru (Tanjung Baru)	Tanah Datar
Tanjung	Tabalong
Tanjung	Lombok Utara
Tanjung	Brebes
Tanjung Agung	Muara Enim
Tanjung Agung Palik	Bengkulu Utara
Tanjung Balai	Asahan
Tanjung Balai Selatan	Tanjung Balai
Tanjung Balai Utara	Tanjung Balai
Tanjung Batu	Ogan Ilir
Tanjung Beringin	Serdang Bedagai
Tanjung Bintang	Lampung Selatan
Tanjung Bumi (Tanjungbumi)	Bangkalan
Tanjung Bunga	Flores Timur
Tanjung Emas	Tanah Datar
Tanjung Gadang	Sijunjung
Tanjung Harapan	Solok
Tanjung Harapan	Paser
Tanjung Kemuning	Kaur
Tanjung Lago	Banyuasin
Tanjung Lubuk	Ogan Komering Ilir
Tanjung Medan	Rokan Hilir
Tanjung Morawa	Deli Serdang
Tanjung Mutiara	Agam
Tanjung Palas	Bulungan
Tanjung Palas Barat	Bulungan
Tanjung Palas Tengah	Bulungan
Tanjung Palas Timur	Bulungan
Tanjung Palas Utara	Bulungan
Tanjung Pandan	Belitung
Tanjung Pinang Barat	Tanjung Pinang
Tanjung Pinang Kota	Tanjung Pinang
Tanjung Pinang Timur	Tanjung Pinang
Tanjung Priok	Jakarta Utara
Tanjung Pura (Tanjungpura)	Langkat
Tanjung Raja	Ogan Ilir
Tanjung Raja	Lampung Utara
Tanjung Raya	Mesuji
Tanjung Raya	Agam
Tanjung Redeb	Berau
Tanjung Sakti Pumi	Lahat
Tanjung Sari	Lampung Selatan
Tanjung Selor	Bulungan
Tanjung Senang	Bandar Lampung
Tanjung Tiram	Batu Bara
Tanjunganom	Nganjuk
Tanjungjaya	Tasikmalaya
Tanjungkarang Barat (Tanjung Karang Barat)	Bandar Lampung
Tanjungkarang Pusat (Tanjung Karang Pusat)	Bandar Lampung
Tanjungkarang Timur (Tanjung Karang Timur)	Bandar Lampung
Tanjungkerta	Sumedang
Tanjungmedar	Sumedang
Tanjungsakti Pumu (Tanjung Sakti Pumu)	Lahat
Tanjungsari	Gunung Kidul
Tanjungsari	Bogor
Tanjungsari	Sumedang
Tanjungsiang	Subang
Tanjungtebat (Tanjung Tebat)	Lahat
Tano Tombangan Angkola	Tapanuli Selatan
Tanoh Alas (Tanah Alas)	Aceh Tenggara
Tanon	Sragen
Tanralili	Maros
Tanta	Tabalong
Taopa	Parigi Moutong
Tapa	Bone Bolango
Tapaktuan (Tapak Tuan)	Aceh Selatan
Tapalang	Mamuju
Tapalang Barat	Mamuju
Tapango	Polewali Mandar
Tapen	Bondowoso
Tapian Dolok	Simalungun
Tapian Nauli	Tapanuli Tengah
Tapin Selatan	Tapin
Tapin Tengah	Tapin
Tapin Utara	Tapin
Tapos	Depok
Tapung	Kampar
Tapung Hilir	Kampar
Tapung Hulu	Kampar
Tarabintang (Tara Bintang)	Humbang Hasundutan
Taraju	Tasikmalaya
Tarakan Barat	Tarakan
Tarakan Tengah	Tarakan
Tarakan Timur	Tarakan
Tarakan Utara	Tarakan
Tarano	Sumbawa
Tareran	Minahasa Selatan
Tarik	Sidoarjo
Tarogong Kaler	Garut
Tarogong Kidul	Garut
Tarokan	Kediri
Tarowang	Jeneponto
Tarub	Tegal
Tarumajaya	Bekasi
Tarup	Pegunungan Bintang
Tarutung	Tapanuli Utara
Tasifeto Barat	Belu
Tasifeto Timur	Belu
Tasik Payawan	Katingan
Tasik Putri Puyu	Kepulauan Meranti
Tasikmadu	Karanganyar
Tatah Makmur	Banjar
Tatanga	Palu
Tatapaan	Minahasa Selatan
Tatoareng	Kepulauan Sangihe
Tawaeli	Palu
Tawalian	Mamasa
Tawang	Tasikmalaya
Tawangharjo	Grobogan
Tawangmangu	Karanganyar
Tawangsari	Sukoharjo
Tayan Hilir	Sanggau
Tayan Hulu	Sanggau
Tayando Tam	Tual
Tayu	Pati
Tebas	Sambas
Tebat Karai	Kepahiang
Tebet	Jakarta Selatan
Tebing	Karimun
Tebing Syahbandar	Serdang Bedagai
Tebing Tinggi	Serdang Bedagai
Tebing Tinggi	Balangan
Tebing Tinggi	Tanjung Jabung Barat
Tebing Tinggi	Kepulauan Meranti
Tebing Tinggi	Empat Lawang
Tebing Tinggi Barat	Kepulauan Meranti
Tebing Tinggi Kota	Tebing Tinggi
Tebing Tinggi Timur	Kepulauan Meranti
Tebo Ilir	Tebo
Tebo Tengah	Tebo
Tebo Ulu	Tebo
Tegal Barat	Tegal
Tegal Selatan	Tegal
Tegal Timur	Tegal
Tegalampel	Bondowoso
Tegalbuleud	Sukabumi
Tegaldlimo	Banyuwangi
Tegallalang	Gianyar
Tegalombo	Pacitan
Tegalrejo	Yogyakarta
Tegalrejo	Magelang
Tegalsari	Banyuwangi
Tegalsari	Surabaya
Tegalsiwalan (Tegal Siwalan)	Probolinggo
Tegalwaru	Karawang
Tegalwaru (Tegal Waru)	Purwakarta
Tegineneng	Pesawaran
Tegowanu	Grobogan
Tehoru	Maluku Tengah
Teiraplu	Pegunungan Bintang
Tejakula	Buleleng
Tekarang	Sambas
Tekung	Lumajang
Telaga	Gorontalo
Telaga Antang	Kotawaringin Timur
Telaga Bauntung	Banjar
Telaga Biru	Gorontalo
Telaga Langsat	Hulu Sungai Selatan
Telagasari (Talagasari)	Karawang
Telanaipura	Jambi
Telawang	Kotawaringin Timur
Telen	Kutai Timur
Telenggeme	Tolikara
Tellu Limpoe	Sidenreng Rappang
Tellu Limpoe	Sinjai
Tellu Siattinge	Bone
Tellulimpoe (Tellu Limpoe)	Bone
Telluwanua	Palopo
Telok Sebong (Teluk Sebong)	Bintan
Teluk Ambon	Ambon
Teluk Ampimoi	Kepulauan Yapen
Teluk Arguni Atas	Kaimana
Teluk Arguni Bawah (Yerusi)	Kaimana
Teluk Batang	Kayong Utara
Teluk Bayur	Berau
Teluk Belengkong	Indragiri Hilir
Teluk Bintan	Bintan
Teluk Dalam	Simeulue
Teluk Dalam	Nias Selatan
Teluk Dalam	Asahan
Teluk Deya	Paniai
Teluk Duairi	Teluk Wondama
Teluk Elpaputih	Maluku Tengah
Teluk Etna	Kaimana
Teluk Gelam	Ogan Komering Ilir
Teluk Kaiely	Buru
Teluk Keramat	Sambas
Teluk Kimi	Nabire
Teluk Mayalibit	Raja Ampat
Teluk Mengkudu	Serdang Bedagai
Teluk Meranti	Pelalawan
Teluk Mutiara	Alor
Teluk Nibung	Tanjung Balai
Teluk Pakedai	Kubu Raya
Teluk Pandan	Kutai Timur
Teluk Pandan	Pesawaran
Teluk Patipi	Fakfak
Teluk Sampit	Kotawaringin Timur
Teluk Segara	Bengkulu
Teluk Umar	Nabire
Teluk Waru	Seram Bagian Timur
Telukbetung Barat	Bandar Lampung
Telukbetung Selatan	Bandar Lampung
Telukbetung Timur	Bandar Lampung
Telukbetung Utara	Bandar Lampung
Telukjambe Barat	Karawang
Telukjambe Timur	Karawang
Teluknaga	Tangerang
Telutih	Maluku Tengah
Temanggung	Temanggung
Temayang	Bojonegoro
Tembagapura	Mimika
Tembalang	Semarang
Tembarak	Temanggung
Tembelang	Jombang
Tembilahan	Indragiri Hilir
Tembilahan Hulu	Indragiri Hilir
Tembuku	Bangli
Tembuni	Teluk Bintuni
Temiang Pesisir	Lingga
Teminabuan	Sorong Selatan
Temon	Kulon Progo
Tempe	Wajo
Tempeh	Lumajang
Tempel	Sleman
Tempilang	Bangka Barat
Tempuling	Indragiri Hilir
Tempunak	Sintang
Tempuran	Karawang
Tempuran	Magelang
Tempurejo	Jember
Tempursari	Lumajang
Tenayan Raya	Pekanbaru
Tenga	Minahasa Selatan
Tengah Ilir	Tebo
Tengah Tani	Cirebon
Tengaran	Semarang
Tenggarang	Bondowoso
Tenggarong	Kutai Kartanegara
Tenggarong Seberang	Kutai Kartanegara
Tenggilis Mejoyo	Surabaya
Tenggulun	Aceh Tamiang
Tenjo	Bogor
Tenjolaya	Bogor
Teon Nila Serua	Maluku Tengah
Teor	Seram Bagian Timur
Tepus	Gunung Kidul
Teramang Jaya	Muko Muko
Terangun (Terangon)	Gayo Lues
Terara	Lombok Timur
Teras	Boyolali
Teras Terunjam	Muko Muko
Terbanggi Besar	Lampung Tengah
Terentang	Kubu Raya
Teriak	Bengkayang
Tering	Kutai Barat
Teripe/Tripe Jaya	Gayo Lues
Ternate Barat	Ternate
Tersono	Batang
Terusan Nunyai	Lampung Tengah
Testega	Pegunungan Arfak
Tetap (Muara Tetap)	Kaur
Teunom	Aceh Jaya
Teupah Barat	Simeulue
Teupah Selatan	Simeulue
Teupah Tengah	Simeulue
Tewah	Gunung Mas
Tewang Sangalang / Sanggalang Garing	Katingan
Teweh Baru	Barito Utara
Teweh Selatan	Barito Utara
Teweh Tengah	Barito Utara
Teweh Timur	Barito Utara
Ti Zain	Mappi
Tiang Pumpung	Merangin
Tiang Pumpung Kepungut	Musi Rawas
Tibawa	Gorontalo
Tidore	Tidore Kepulauan
Tidore Selatan	Tidore Kepulauan
Tidore Timur	Tidore Kepulauan
Tidore Utara	Tidore Kepulauan
Tiga Dihaji	Ogan Komering Ulu Selatan
Tigabinanga (Tiga Binanga)	Karo
Tigalingga (Tiga Lingga)	Dairi
Tiganderket	Karo
Tigapanah (Tiga Panah)	Karo
Tigaraksa	Tangerang
Tigi	Deiyai
Tigi Barat	Deiyai
Tigi Timur	Deiyai
Tigo Lurah	Solok
Tigo Nagari	Pasaman
Tikala	Toraja Utara
Tikala	Manado
Tikke Raya	Pasangkayu (Mamuju Utara)
Tikung	Lamongan
Tilamuta	Boalemo
Tilango	Gorontalo
Tilatang Kamang	Agam
Tiloan	Buol
Tilongkabila	Bone Bolango
Timang Gajah	Bener Meriah
Timori	Tolikara
Timpah	Kapuas
Timpeh	Dharmasraya
Tinada	Pakpak Bharat
Tinambung	Polewali Mandar
Tinanggea	Konawe Selatan
Tinangkung	Banggai Kepulauan
Tinangkung Selatan	Banggai Kepulauan
Tinangkung Utara	Banggai Kepulauan
Tinggi Raja	Asahan
Tinggimoncong	Gowa
Tingginambut	Puncak Jaya
Tinggouw	Tambrauw
Tingkir	Salatiga
Tinombo	Parigi Moutong
Tinombo Selatan	Parigi Moutong
Tinondo	Kolaka Timur
Tiom	Lanny Jaya
Tiom Ollo	Lanny Jaya
Tiomneri	Lanny Jaya
Tiplol Mayalibit	Raja Ampat
Tirawuta	Kolaka Timur
Tiris	Probolinggo
Tiro/Truseb	Pidie
Tiroang	Pinrang
Tirtajaya	Karawang
Tirtamulya	Karawang
Tirtayasa	Serang
Tirto	Pekalongan
Tirtomoyo	Wonogiri
Tirtoyudo	Malang
Titehena	Flores Timur
Titeue	Pidie
Tiumang	Dharmasraya
Tiworo Kepulauan	Muna Barat
Tiworo Selatan	Muna Barat
Tiworo Tengah	Muna Barat
Tiworo Utara	Muna Barat
Tiwu	Kolaka Utara
Tlanakan	Pamekasan
Tlogomulyo	Temanggung
Tlogosari	Bondowoso
Tlogowungu	Pati
Toapaya	Bintan
Toari	Kolaka
Toba	Sanggau
Tobadak	Mamuju Tengah
Tobelo	Halmahera Utara
Tobelo Barat	Halmahera Utara
Tobelo Selatan	Halmahera Utara
Tobelo Tengah	Halmahera Utara
Tobelo Timur	Halmahera Utara
Tobelo Utara	Halmahera Utara
Toboali	Bangka Selatan
Tobouw	Tambrauw
Tobu	Timor Tengah Selatan
Todanan	Blora
Togean	Tojo Una-Una
Togo Binongko	Wakatobi
Toho	Mempawah
Toianas	Timor Tengah Selatan
Toili	Banggai
Toili Barat	Banggai
Tojo	Tojo Una-Una
Tojo Barat	Tojo Una-Una
Tolala	Kolaka Utara
Tolangohula	Gorontalo
Toli-Toli Utara (Tolitoli Utara)	Toli-Toli
Tolinggula	Gorontalo Utara
Toma	Nias Selatan
Tomage	Fakfak
Tombariri	Minahasa
Tombariri Timur	Minahasa
Tombatu	Minahasa Tenggara
Tombatu Timur	Minahasa Tenggara
Tombatu Utara	Minahasa Tenggara
Tombolopao (Tombolo Pao)	Gowa
Tombulu	Minahasa
Tomia	Wakatobi
Tomia Timur	Wakatobi
Tomini	Parigi Moutong
Tomini	Bolaang Mongondow Selatan
Tommo	Mamuju
Tomo	Sumedang
Tomohon Barat	Tomohon
Tomohon Selatan	Tomohon
Tomohon Tengah	Tomohon
Tomohon Timur	Tomohon
Tomohon Utara	Tomohon
Tomolito	Gorontalo Utara
Tomoni	Luwu Timur
Tomoni Timur	Luwu Timur
Tomosiga	Intan Jaya
Tompaso	Minahasa
Tompaso Barat	Minahasa
Tompaso Baru	Minahasa Selatan
Tompo Bulu (Tompobulu)	Bantaeng
Tompobullu (Tompobulu)	Gowa
Tompobulu (Tompu Bulu)	Maros
Tomu	Teluk Bintuni
Tondano Barat	Minahasa
Tondano Selatan	Minahasa
Tondano Timur	Minahasa
Tondano Utara	Minahasa
Tondon	Toraja Utara
Tondong Tallasa	Pangkajene Kepulauan
Tongas	Probolinggo
Tongauna	Konawe
Tongkuno	Muna
Tongkuno Selatan	Muna
Tonjong	Brebes
Tonra	Bone
Tontonunu	Bombana
Topiyai	Paniai
Topos	Lebong
Topoyo	Mamuju Tengah
Tor Atas	Sarmi
Torere	Puncak Jaya
Torgamba	Labuhanbatu Selatan
Toribulu	Parigi Moutong
Torjun	Sampang
Toroh	Grobogan
Torue	Parigi Moutong
Tosari	Pasuruan
Totikum (Totikung)	Banggai Kepulauan
Totikum Selatan	Banggai Kepulauan
Touluaan	Minahasa Tenggara
Touluaan Selatan	Minahasa Tenggara
Towe	Keerom
Towea	Muna
Towuti	Luwu Timur
Tragah	Bangkalan
Trangkil	Pati
Trawas	Mojokerto
Trenggalek	Trenggalek
Tretep	Temanggung
Trienggadeng	Pidie Jaya
Trikora	Jayawijaya
Trimurjo	Lampung Tengah
Tripa Makmur	Nagan Raya
Trisi/Terisi	Indramayu
Trowulan	Mojokerto
Trucuk	Klaten
Trucuk	Bojonegoro
Trumon	Aceh Selatan
Trumon Tengah	Aceh Selatan
Trumon Timur	Aceh Selatan
Tuah Negeri	Musi Rawas
Tualan Hulu	Kotawaringin Timur
Tualang	Siak
Tuban	Tuban
Tubang	Merauke
Tubbi Taramanu (Tutar/Tutallu)	Polewali Mandar
Tubo (Tubo Sendana)	Majene
Tugala Oyo	Nias Utara
Tugu	Semarang
Tugu	Trenggalek
Tugumulyo	Musi Rawas
Tuhemberua	Nias Utara
Tuhiba	Teluk Bintuni
Tujuh Belas	Bengkayang
Tukak Sadai	Bangka Selatan
Tukdana	Indramayu
Tukka	Tapanuli Tengah
Tulakan	Pacitan
Tulang Bawang Tengah	Tulang Bawang Barat
Tulang Bawang Udik	Tulang Bawang Barat
Tulangan	Sidoarjo
Tulin Onsoi	Nunukan
Tulis	Batang
Tulung	Klaten
Tulung Selapan	Ogan Komering Ilir
Tulungagung	Tulungagung
Tumbang Titi	Ketapang
Tumijajar	Tulang Bawang Barat
Tuminiting	Manado
Tumpaan	Minahasa Selatan
Tumpang	Malang
Tungkal Ilir	Tanjung Jabung Barat
Tungkal Ilir	Banyuasin
Tungkal Jaya	Musi Banyuasin
Tungkal Ulu	Tanjung Jabung Barat
Tunjung Teja	Serang
Tunjungan	Blora
Tuntang	Semarang
Turatea	Jeneponto
Turen	Malang
Turi	Lamongan
Turi	Sleman
Turikale	Maros
Tutuk Tolu	Seram Bagian Timur
Tutur	Pasuruan
Tutuyan	Bolaang Mongondow Timur
Ubahak	Yahukimo
Ubalihi	Yahukimo
Ubud	Gianyar
Udanawu	Blitar
Ueesi	Kolaka Timur
Uepai	Konawe
Ugimba	Intan Jaya
Ujan Mas	Muara Enim
Ujan Mas	Kepahiang
Ujung	Parepare
Ujung Batu	Rokan Hulu
Ujung Batu	Padang Lawas Utara
Ujung Bulu	Bulukumba
Ujung Padang	Simalungun
Ujung Pandang	Makassar
Ujung Tanah	Makassar
Ujungberung (Ujung Berung)	Bandung
Ujungjaya	Sumedang
Ujungloe (Ujung Loe)	Bulukumba
Ujungpangkah (Ujung Pangkah)	Gresik
Ukha	Yahukimo
Ukui	Pelalawan
Ulakan Tapakih	Padang Pariaman
Ulaweng	Bone
Ulee Kareng	Banda Aceh
Ulilin	Merauke
Ulim	Pidie Jaya
Ulok Kupai	Bengkulu Utara
Ulu Barumun	Padang Lawas
Ulu Belu (Ulubelu)	Tanggamus
Ulu Idanotae	Nias Selatan
Ulu Manna	Bengkulu Selatan
Ulu Moro'o (Ulu Narwo)	Nias Barat
Ulu Musi	Empat Lawang
Ulu Ogan	Ogan Komering Ulu
Ulu Pungkut	Mandailing Natal
Ulu Rawas	Musi Rawas Utara
Ulu Talo	Seluma
Uluan	Toba Samosir
Ulubongka	Tojo Una-Una
Uluere	Bantaeng
Ulugawo	Nias
Uluiwoi	Kolaka Timur
Ulujadi	Palu
Ulujami	Pemalang
Ulumanda (Ulumunda)	Majene
Ulunoyo	Nias Selatan
Ulususua	Nias Selatan
Umagi	Tolikara
Umalulu	Sumba Timur
Umbu Ratu Nggay	Sumba Tengah
Umbu Ratu Nggay Barat	Sumba Tengah
Umbulharjo	Yogyakarta
Umbulsari	Jember
Umbunasi	Nias Selatan
Una Una	Tojo Una-Una
Unaaha	Konawe
Undaan	Kudus
Ungar	Karimun
Ungaran Barat	Semarang
Ungaran Timur	Semarang
Unir Sirau	Asmat
Unter Iwes (Unterwiris)	Sumbawa
Unurum Guay	Jayapura
Upau	Tabalong
Uram Jaya	Lebong
Urei Faisei	Waropen
Usilimo	Jayawijaya
Utan	Sumbawa
Uut Murung	Murung Raya
Uwapa	Nabire
V Koto	Muko Muko
V Koto Kampung Dalam	Padang Pariaman
V Koto Timur	Padang Pariaman
Venaha	Mappi
VII Koto	Tebo
VII Koto Ilir	Tebo
VII Koto Sungai Sarik	Padang Pariaman
Waan	Merauke
Wabula	Buton
Wadaga	Muna Barat
Wadangku	Jayawijaya
Wadaslintang	Wonosobo
Wado	Sumedang
Wae Rii	Manggarai
Waeapo	Buru
Waegi	Puncak Jaya
Waelata	Buru
Waesama	Buru Selatan
Wagir	Malang
Waiblama	Sikka
Waibu	Jayapura
Waigeo Barat	Raja Ampat
Waigeo Barat Kepulauan	Raja Ampat
Waigeo Selatan	Raja Ampat
Waigeo Timur	Raja Ampat
Waigeo Utara	Raja Ampat
Waigete	Sikka
Wajak	Malang
Wajo	Makassar
Wakate	Seram Bagian Timur
Wakorumba Selatan	Muna
Wakorumba Utara	Buton Utara
Wakuwo	Tolikara
Walaik	Jayawijaya
Walantaka	Serang
Walea Besar	Tojo Una-Una
Walea Kepulauan	Tojo Una-Una
Waled	Cirebon
Walelagama	Jayawijaya
Walenrang	Luwu
Walenrang Barat	Luwu
Walenrang Timur	Luwu
Walenrang Utara	Luwu
Walma	Yahukimo
Waluran	Sukabumi
Wame	Jayawijaya
Wamena	Jayawijaya
Wamesa	Teluk Wondama
Wamesa (Idoor)	Teluk Bintuni
Wampu	Langkat
Wanadadi (Wonodadi)	Banjarnegara
Wanaraja	Garut
Wanaraya	Barito Kuala
Wanareja	Cilacap
Wanasaba	Lombok Timur
Wanasalam	Lebak
Wanasari	Brebes
Wanayasa	Purwakarta
Wanayasa	Banjarnegara
Wandai	Intan Jaya
Wanea	Manado
Wangbe	Puncak
Wanggar	Nabire
Wanggarasi	Pohuwato
Wangi Wangi	Wakatobi
Wangi Wangi Selatan	Wakatobi
Wangon	Banyumas
Wania	Mimika
Wano Barat	Lanny Jaya
Wanokaka	Sumba Barat
Wanwi	Puncak Jaya
Waplau	Buru
Wapoga	Nabire
Wapoga	Waropen
Wara	Palopo
Wara Barat	Palopo
Wara Selatan	Palopo
Wara Timur	Palopo
Wara Utara	Palopo
Wari / Taiyeve II	Tolikara
Waringinkurung (Waringin Kurung)	Serang
Waris	Keerom
Warkuk Ranau Selatan	Ogan Komering Ulu Selatan
Warmare	Manokwari
Waropen Atas	Mamberamo Raya
Waropen Bawah	Waropen
Waropko	Boven Digoel
Warsa	Biak Numfor
Waru	Pamekasan
Waru	Sidoarjo
Waru	Penajam Paser Utara
Warudoyong	Sukabumi
Warungasem	Batang
Warunggunung	Lebak
Warungkiara	Sukabumi
Warungkondang	Cianjur
Warungpring	Pemalang
Warureja (Warurejo)	Tegal
Warwarbomi	Raja Ampat
Wasile	Halmahera Timur
Wasile Selatan	Halmahera Timur
Wasile Tengah	Halmahera Timur
Wasile Timur	Halmahera Timur
Wasile Utara	Halmahera Timur
Wasior	Teluk Wondama
Wasuponda	Luwu Timur
Watang Pulu	Sidenreng Rappang
Watang Sawito (Watang Sawitto)	Pinrang
Wates	Kulon Progo
Wates	Blitar
Wates	Kediri
Watopute	Muna
Wattang Sidenreng (Watang Sidenreng)	Sidenreng Rappang
Watubangga	Kolaka
Watukumpul	Pemalang
Watulimo	Trenggalek
Watumalang	Wonosobo
Watunohu	Kolaka Utara
Waway Karya	Lampung Timur
Wawo	Bima
Wawo	Kolaka Utara
Wawolesea	Konawe Utara
Wawonii Barat	Konawe Kepulauan
Wawonii Selatan	Konawe Kepulauan
Wawonii Tengah	Konawe Kepulauan
Wawonii Tenggara	Konawe Kepulauan
Wawonii Timur	Konawe Kepulauan
Wawonii Timur Laut	Konawe Kepulauan
Wawonii Utara	Konawe Kepulauan
Wawotobi	Konawe
Way Bungur (Purbolinggo Utara)	Lampung Timur
Way Halim	Bandar Lampung
Way Jepara	Lampung Timur
Way Kenanga	Tulang Bawang Barat
Way Khilau	Pesawaran
Way Krui	Pesisir Barat
Way Lima	Pesawaran
Way Pangubuan	Lampung Tengah
Way Panji	Lampung Selatan
Way Ratai	Pesawaran
Way Seputih	Lampung Tengah
Way Serdang	Mesuji
Way Sulan	Lampung Selatan
Way Tenong	Lampung Barat
Way Tuba	Way Kanan
Wayer	Sorong Selatan
Web	Keerom
Weda	Halmahera Tengah
Weda Selatan	Halmahera Tengah
Weda Tengah	Halmahera Tengah
Weda Timur	Halmahera Tengah
Weda Utara	Halmahera Tengah
Wedarijaksa	Pati
Wedi	Klaten
Wedung	Demak
Wegee Bino	Paniai
Wegee Muka	Paniai
Weime	Pegunungan Bintang
Welahan	Jepara
Welak	Manggarai Barat
Welarek	Yalimo
Weleri	Kendal
Welesi	Jayawijaya
Weliman	Malaka
Wemak	Sorong
Wenam	Tolikara
Wenang	Manado
Wer Maktian	Kepulauan Tanimbar (Maluku Tenggara Barat)
Wer Tamrian	Kepulauan Tanimbar (Maluku Tenggara Barat)
Wera	Bima
Wereka	Lanny Jaya
Weriagar	Teluk Bintuni
Werima	Yahukimo
Werinama	Seram Bagian Timur
Weru	Cirebon
Weru	Sukoharjo
Wesaput	Jayawijaya
Wetar	Maluku Barat Daya
Wetar Barat	Maluku Barat Daya
Wetar Timur	Maluku Barat Daya
Wetar Utara	Maluku Barat Daya
Wewaria	Ende
Wewewa Barat	Sumba Barat Daya
Wewewa Selatan	Sumba Barat Daya
Wewewa Tengah	Sumba Barat Daya
Wewewa Timur	Sumba Barat Daya
Wewewa Utara	Sumba Barat Daya
Wewiku	Malaka
Widang	Tuban
Widasari	Indramayu
Widodaren	Ngawi
Wih Pesam	Bener Meriah
Wilangan	Nganjuk
Wilhem Roumbouts	Tambrauw
Wina	Tolikara
Windesi	Kepulauan Yapen
Windesi	Teluk Wondama
Windusari	Magelang
Winong	Pati
Winongan	Pasuruan
Wiradesa	Pekalongan
Wiringgambut	Lanny Jaya
Wirobrajan	Yogyakarta
Wirosari	Grobogan
Wita Ponda	Morowali
Wita Waya	Jayawijaya
Witihama	Flores Timur
Wiwirano	Konawe Utara
Wiyung	Surabaya
Wlingi	Blitar
Woha	Bima
Woja	Dompu
Wolasi	Konawe Selatan
Wolio	Bau-Bau
Wollo (Wolo)	Jayawijaya
Wolo	Kolaka
Wolojita	Ende
Wolomeze (Riung Selatan)	Ngada
Wolowa	Buton
Wolowae	Nagekeo
Wolowaru	Ende
Wonawa	Kepulauan Yapen
Wondiboy	Teluk Wondama
Wonggeduku	Konawe
Wonggeduku Barat	Konawe
Wongsorejo	Banyuwangi
Wonoasih	Probolinggo
Wonoasri	Madiun
Wonoayu	Sidoarjo
Wonoboyo	Temanggung
Wonocolo	Surabaya
Wonodadi	Blitar
Wonogiri	Wonogiri
Wonokerto	Pekalongan
Wonoki (Woniki)	Tolikara
Wonokromo	Surabaya
Wonomerto	Probolinggo
Wonomulyo	Polewali Mandar
Wonopringgo	Pekalongan
Wonorejo	Pasuruan
Wonosalam	Demak
Wonosalam	Jombang
Wonosamodro	Boyolali
Wonosari	Gunung Kidul
Wonosari	Boalemo
Wonosari	Klaten
Wonosari	Bondowoso
Wonosari	Malang
Wonosegoro	Boyolali
Wonosobo	Wonosobo
Wonosobo	Tanggamus
Wonotirto	Blitar
Wonotunggal	Batang
Wonti	Waropen
Wori	Minahasa Utara
Wosak	Nduga
Wotan Ulumando	Flores Timur
Wotu	Luwu Timur
Wouma	Jayawijaya
Woyla	Aceh Barat
Woyla Barat	Aceh Barat
Woyla Timur	Aceh Barat
Wringin	Bondowoso
Wringinanom (Wringin Anom)	Gresik
Wua-Wua	Kendari
Wuar Labobar	Kepulauan Tanimbar (Maluku Tenggara Barat)
Wugi	Tolikara
Wulandoni	Lembata
Wulanggitang	Flores Timur
Wulla Waijelu (Wula Waijelu)	Sumba Timur
Wuluhan	Jember
Wundulako	Kolaka
Wungu	Madiun
Wunim (Wunin / Wumin)	Tolikara
Wuryantoro	Wonogiri
Wusama (Wusuma)	Yahukimo
Wusi	Nduga
Wutpaga	Nduga
X Koto Diatas	Solok
X Koto Singkarak	Solok
XIII Koto Kampar	Kampar
XIV Koto	Muko Muko
Yaffi	Keerom
Yagai	Paniai
Yahuliambut	Yahukimo
Yakomi	Mappi
Yal	Nduga
Yalengga	Jayawijaya
Yambi	Puncak Jaya
Yamo	Puncak Jaya
Yamoneri	Puncak Jaya
Yamor	Kaimana
Yaniruma	Boven Digoel
Yapen Barat	Kepulauan Yapen
Yapen Selatan	Kepulauan Yapen
Yapen Timur	Kepulauan Yapen
Yapen Utara	Kepulauan Yapen
Yapsi	Jayapura
Yaro (Yaro Kabisay)	Nabire
Yaru	Kepulauan Tanimbar (Maluku Tenggara Barat)
Yatamo	Paniai
Yaur	Nabire
Yawakukat	Kepulauan Yapen
Yawosi	Biak Numfor
Yembun	Tambrauw
Yendidori	Biak Numfor
Yenggelo	Nduga
Yigi	Nduga
Yiginua	Lanny Jaya
Yiluk	Lanny Jaya
Yogosem	Yahukimo
Yokari	Jayapura
Yosowilangun	Lumajang
Youtadi	Paniai
Yugumuak	Puncak
Yugungwi	Lanny Jaya
Yuko	Tolikara
Yuneri	Tolikara